18禁	18禁 🔞
A	A 🅰️
AB	AB 🆎
ABCD	ABCD 🔠
AB型	AB型 🆎
AB型血	AB型血 🆎
AB血型	AB血型 🆎
ATM	ATM 🏧
Afghanistan	Afghanistan 🇦🇫
African	African 🇨🇫
Albania	Albania 🇦🇱
Algeria	Algeria 🇩🇿
Andorra	Andorra 🇦🇩
Angola	Angola 🇦🇴
Anguilla	Anguilla 🇦🇮
Antarctica	Antarctica 🇦🇶
Antigua	Antigua 🇦🇬
Arab	Arab 🇦🇪
Argentina	Argentina 🇦🇷
Armenia	Armenia 🇦🇲
Aruba	Aruba 🇦🇼
Ascension	Ascension 🇦🇨
Australia	Australia 🇦🇺
Austria	Austria 🇦🇹
Azerbaijan	Azerbaijan 🇦🇿
A型	A型 🅰️
A型血	A型血 🅰️
A血型	A血型 🅰️
B	B 🅱️
BP机	BP机 📟
Bahamas	Bahamas 🇧🇸
Bahrain	Bahrain 🇧🇭
Bangladesh	Bangladesh 🇧🇩
Barbados	Barbados 🇧🇧
Barbuda	Barbuda 🇦🇬
Belarus	Belarus 🇧🇾
Belgium	Belgium 🇧🇪
Belize	Belize 🇧🇿
Benin	Benin 🇧🇯
Bermuda	Bermuda 🇧🇲
Bhutan	Bhutan 🇧🇹
Bolivia	Bolivia 🇧🇴
Bosnia	Bosnia 🇧🇦
Botswana	Botswana 🇧🇼
Bouvet	Bouvet 🇧🇻
Brazil	Brazil 🇧🇷
Brunei	Brunei 🇧🇳
Bulgaria	Bulgaria 🇧🇬
BurkinaFaso	BurkinaFaso 🇧🇫
Burundi	Burundi 🇧🇮
B型	B型 🅱️
B型血	B型血 🅱️
B血型	B血型 🅱️
CD	CD 💿
Cambodia	Cambodia 🇰🇭
Cameroon	Cameroon 🇨🇲
Canada	Canada 🇨🇦
Caribbean	Caribbean 🇧🇶
Ceuta	Ceuta 🇪🇦
Chad	Chad 🇹🇩
Chile	Chile 🇨🇱
China	China 🇨🇳
Christmas	Christmas 🇨🇽
Clipperton	Clipperton 🇨🇵
Cocos	Cocos 🇨🇨
Colombia	Colombia 🇨🇴
Congo	Congo 🇨🇩 🇨🇬
Cook	Cook 🇨🇰
Copyright	Copyright ©
Croatia	Croatia 🇭🇷
Cuba	Cuba 🇨🇺
Curaçao	Curaçao 🇨🇼
Cyprus	Cyprus 🇨🇾
Czech	Czech 🇨🇿
DNA	DNA 🧬
DVD	DVD 📀
Denmark	Denmark 🇩🇰
Djibouti	Djibouti 🇩🇯
Doge	Doge 🐶
Dominica	Dominica 🇩🇲 🇩🇴
Ecuador	Ecuador 🇪🇨
Egypt	Egypt 🇪🇬
Eritrea	Eritrea 🇪🇷
Estonia	Estonia 🇪🇪
Ethiopia	Ethiopia 🇪🇹
Falkland	Falkland 🇫🇰
Faroe	Faroe 🇫🇴
Fiji	Fiji 🇫🇯
Finland	Finland 🇫🇮
France	France 🇫🇷
Gabon	Gabon 🇬🇦
Gambia	Gambia 🇬🇲
Georgia	Georgia 🇬🇪
Germany	Germany 🇩🇪
Ghana	Ghana 🇬🇭
Gibraltar	Gibraltar 🇬🇮
Greece	Greece 🇬🇷
Greenland	Greenland 🇬🇱
Grenada	Grenada 🇬🇩
Guam	Guam 🇬🇺
Guatemala	Guatemala 🇬🇹
Guinea	Guinea 🇬🇳
Haiti	Haiti 🇭🇹
Herzegovina	Herzegovina 🇧🇦
Honduras	Honduras 🇭🇳
Hungary	Hungary 🇭🇺
ID	ID 🪪 🆔
Iceland	Iceland 🇮🇸
India	India 🇮🇳
Indonesia	Indonesia 🇮🇩
Iran	Iran 🇮🇷
Iraq	Iraq 🇮🇶
Ireland	Ireland 🇮🇪
Israel	Israel 🇮🇱
Italy	Italy 🇮🇹
Jamaica	Jamaica 🇯🇲
Japan	Japan 🇯🇵 🗾 🎌
Jordan	Jordan 🇯🇴
Kazakhstan	Kazakhstan 🇰🇿
Kenya	Kenya 🇰🇪
Kiribati	Kiribati 🇰🇮
Korea	Korea 🇰🇵 🇰🇷
Kosovo	Kosovo 🇽🇰
Kuwait	Kuwait 🇰🇼
Kyrgyzstan	Kyrgyzstan 🇰🇬
K歌	K歌 🪩
Latvia	Latvia 🇱🇻
Lebanon	Lebanon 🇱🇧
Lesotho	Lesotho 🇱🇸
Liberia	Liberia 🇱🇷
Libya	Libya 🇱🇾
Liechtenstein	Liechtenstein 🇱🇮
Lithuania	Lithuania 🇱🇹
Luxemburg	Luxemburg 🇱🇺
Macau	Macau 🇲🇴
Macedonia	Macedonia 🇲🇰
Madagascar	Madagascar 🇲🇬
Malawi	Malawi 🇲🇼
Malaysia	Malaysia 🇲🇾
Maldives	Maldives 🇲🇻
Mali	Mali 🇲🇱
Malta	Malta 🇲🇹
Mauritania	Mauritania 🇲🇷
Mauritius	Mauritius 🇲🇺
Melilla	Melilla 🇪🇦
Mexico	Mexico 🇲🇽
Moldova	Moldova 🇲🇩
Monaco	Monaco 🇲🇨
Mongolia	Mongolia 🇲🇳
Montenegro	Montenegro 🇲🇪
Morocco	Morocco 🇲🇦
Mozambique	Mozambique 🇲🇿
Myanmar	Myanmar 🇲🇲
NG	NG 🆖
NMSL	NMSL 🤬
Namibia	Namibia 🇳🇦
Nauru	Nauru 🇳🇷
Nepal	Nepal 🇳🇵
Netherlands	Netherlands 🇳🇱
Nicaragua	Nicaragua 🇳🇮
Niger	Niger 🇳🇪
Nigeria	Nigeria 🇳🇬
Norway	Norway 🇳🇴
O	O 🅾️
OK	OK 👌 🙆‍♂️ 🙆‍♀️ 🆗
Oman	Oman 🇴🇲
O型	O型 🅾️
O型血	O型血 🅾️
O血型	O血型 🅾️
Pakistan	Pakistan 🇵🇰
Panama	Panama 🇵🇦
Paraguay	Paraguay 🇵🇾
Peru	Peru 🇵🇪
Philippines	Philippines 🇵🇭
Poland	Poland 🇵🇱
Portugal	Portugal 🇵🇹
Python	Python 🐍
Qatar	Qatar 🇶🇦
Registered	Registered ®
Romania	Romania 🇷🇴
Russia	Russia 🇷🇺
Rwanda	Rwanda 🇷🇼
SOS	SOS 🆘
SUV	SUV 🚙
Sahara	Sahara 🇪🇭
Samoa	Samoa 🇼🇸
Senegal	senegal 🇸🇳
Serbia	Serbia 🇷🇸
Singapore	Singapore 🇸🇬
Slovakia	Slovakia 🇸🇰
Slovenia	Slovenia 🇸🇮
Somalia	Somalia 🇸🇴
Spain	Spain 🇪🇸
Sudan	Sudan 🇸🇩
Swaziland	Swaziland 🇸🇿
Sweden	Sweden 🇸🇪
Switzerland	Switzerland 🇨🇭
Syria	Syria 🇸🇾
TM	TM ™
TV	TV 📺
Tajikistan	Tajikistan 🇹🇯
Tanzania	Tanzania 🇹🇿
Thailand	Thailand 🇹🇭
Togo	Togo 🇹🇬
Tonga	Tonga 🇹🇴
Tunisia	Tunisia 🇹🇳
Turkey	Turkey 🇹🇷
Turkmenistan	Turkmenistan 🇹🇲
T恤	T恤 👕
T恤衫	T恤衫 👕
UFO	UFO 🛸
Uganda	Uganda 🇺🇬
Ukraine	Ukraine 🇺🇦
Uruguay	Uruguay 🇺🇾
Uzbekistan	Uzbekistan 🇺🇿
Vatican	Vatican 🇻🇦
Venezuela	Venezuela 🇻🇪
Vietnam	Vietnam 🇻🇳
Vs.	Vs. 🆚
WC	WC 🚻
WIFI	WIFI 🛜
Wi-Fi	Wi-Fi 🛜
WiFi	WiFi 🛜
X光	X光 🩻
X光片	X光片 🩻
X射线	X射线 🩻
Yemen	Yemen 🇾🇪
ZZZ	ZZZ 💤
Zambia	Zambia 🇿🇲
Zimbabwe	Zimbabwe 🇿🇼
[捂脸]	[捂脸] 🫣 つ﹏⊂
abc	abc 🔤
abcd	abcd 🔡
action	action 🎬
aleph	aleph א
alpha	alpha Α 𝛢 α 𝛼
angry	angry 😡 😠 💢
atled	atled ∇
atom	atom ⚛️
baby	baby 👶 🚼
back	back 🔙
beta	beta Β 𝛣 β 𝛽
bikini	bikini 👙
bingo	bingo (o゜▽゜)o☆[BINGO!]
boom	boom 💣
bug	bug 🐛
bye	bye ヾ(￣▽￣)Bye~Bye~ (ToT)/~~~
clear	clear 🆑
cloud	cloud ☁️
cookie	cookie 🍪
cookies	cookies 🍪
cool	cool 🆒
dagger	dagger † ‡ 🗡
del	del ∇
delta	delta Δ 𝛥 δ 𝛿
end	end 🔚
epsilon	epsilon Ε 𝛦 ε 𝜀 ϵ 𝜖
eta	eta Η 𝛨 η 𝜂
fight	fight ⚔️
free	free 🆓
gamma	gamma Γ 𝛤 γ 𝛾
hbar	hbar ℏ ħ
info	info ℹ️
information	information ℹ️
iota	iota Ι 𝛪 ι 𝜄
joker	joker 🃏
kappa	kappa Κ 𝛫 κ 𝜅 ϰ 𝜘
kiss	kiss 💋
lambda	lambda Λ 𝛬 λ 𝜆
link	link 🔗
love	love 💓 💕 👩‍❤️‍👨 ♥️
money	money 💰
nabla	nabla ∇
new	new 🆕
number	number №
omega	omega Ω 𝛺 ω 𝜔
omicron	omicron Ο 𝛰 ο 𝜊
on	on 🔛
orz	orz ○|￣|_
pH	pH ㏗
panda	panda 🐼
parking	parking 🅿️
partial	partial ∂ 𝛛 𝜕 𝝏
party	party 🥳
peace	peace ☮️
phi	phi Φ 𝛷 φ 𝜑 ϕ 𝜙
ppm	ppm ㏙
psi	psi Ψ 𝛹 ψ 𝜓
respect	respect 🫡
rho	rho Ρ 𝛲 ρ 𝜌 ϱ 𝜚
rocket	rocket 🚀
sigma	sigma Σ 𝛴 σ 𝜎
soon	soon 🔜
tau	tau Τ 𝛵 τ 𝜏
theta	theta Θ 𝛩 ϴ 𝛳 θ 𝜃 ϑ 𝜗
top	top 🔝
unbelievable	unbelievable 🫢
up	up 🆙
upsilon	upsilon Υ 𝛶 υ 𝜐
vs	vs 🆚
wireless	wireless 🛜
xi	xi Ξ 𝛯 ξ 𝜉
zeta	zeta Ζ 𝛧 ζ 𝜁
Åland	Åland 🇦🇽
〇	〇 0️⃣
㖿	㖿 ✌🏻️ (＾－＾)V
䢂	䢂 🛗
一	一 1️⃣
七	七 7️⃣
万	万 卍 卐
三	三 3️⃣
上	上 ⬆️ ↑
下	下 ⬇️ ↓
不	不 🙅‍♂️ 🙅‍♀️
东	东 🀀
中	中 🀄
串	串 🍢
乖	乖 😬️ o(*^＠^*)o
乘	乘 ✖️
九	九 9️⃣
书	书 📖 📚
乳	乳 🥛
二	二 2️⃣
云	云 ☁️
五	五 5️⃣
井	井 # ＃ #️⃣
交	交 🈘 ∩
亲	亲 💋
仔	仔 🧒🏻
他	他 👤️ ╭(′•㉨•′)╭☞
代	代 ㈹
企	企 🧍🏻 ㊭ ㈽
伏	伏 ㎴ ㎵ ㎶ ㎷ ㎸ ㎹
休	休 ㊡ ㉁
优	优 ㊝
伞	伞 🌂️
伤	伤 🤕️
你	你 🫵🏻
信	信 ✉️ 💌
倒	倒 🤒️ 🫗
偏	偏 ∂ 𝛛 𝜕 𝝏
停	停 ⛔️ 🛑 ✋
傻	傻 🐷️ 🤪
儿	儿 👦🏻️
克	克 ㎍ ㎎ ㎏ ㌘
兑	兑 ☱
兔	兔 🐰
党	党 ☭
八	八 8️⃣
六	六 6️⃣
兰	兰 🀣
円	円 💴️
再	再 🈞
写	写 ✍🏻️ ㊢
冬	冬 🀩
冰	冰 🧊
冷	冷 🥶
冻	冻 🥶
减	减 ➖
凶	凶 (*￣(エ)￣) (+(工)+╬)
刀	刀 🔪
分	分 ′ ㌣
切	切 🤪  •᷄ࡇ•᷅ (ˉ▽￣～)切~~
初	初 🈠
别	别 (＞﹏＜)
前	前 ➡️ ⬆️ 🈜
剑	剑 ⚔️
剪	剪 ✂️
割	割 🈹
加	加 ➕
劳	劳 ㊘ ㈸
勺	勺 🥄
勾	勾 ✅️ ✔️ ✓ √
包	包 💼
北	北 🀃
匙	匙 🥄
医	医 ㊩
十	十 🔟
千	千 仟 ㌔
升	升 ㎕ ㎖ ㎗ ㎘ ㍑
协	协 ㊯ ㈿
南	南 🀁
印	印 ㊞
厘	厘 ㌢
去	去 乀(ˉεˉ乀) (ーー゛)
叉	叉 ❌ ❎
双	双 🈒
反	反 ¬
发	发 🀅
口	口 👄
可	可 🉑
右	右 ➡️ →
号	号 📯️ 🎺
合	合 🈴
同	同 々 〻
名	名 ㊔ ㈴
后	后 ⬅️ ⬇️ 🈝
吐	吐 🤮
吓	吓 😦️
吨	吨 ㌧
听	听 👂
吹	吹 🌬️ 🈥
吻	吻 💋
呃	呃 🤔
呆	呆 😳 (⊙_⊙)
呼	呼 ㈺
和	和 & ∑ ∧
咦	咦 🤨
哇	哇 😃️ 😯️ [哇] 🤩 wow~⊙o⊙
哈	哈 😄
哎	哎 😮‍💨
哟	哟 😯️
哦	哦 😯
哭	哭 😭
哼	哼 😤️ o(￣ヘ￣o＃)
唇	唇 💋 👄
唉	唉 😮‍💨
唱	唱 🎤️
唵	唵 🕉️
啊	啊 🤔
喂	喂 (#`O′)
喊	喊 🗣️
喔	喔 😮️ 😶️
喜	喜 囍
喵	喵 🐱
営	営 🈺️
嗅	嗅 👃
嗨	嗨 ヾ(≧∇≦*)ゝ (｡･∀･)ﾉﾞ Hi~o(*￣▽￣*)ブ
嗯	嗯 😶️ 🤨
嗷	嗷 ┗|｀O′|┛嗷~~ ヾ(≧O≦)〃嗷~ (>▽<)
嘘	嘘 🤫
嘴	嘴 👄
噎	噎 [噎住](*⊙~⊙)
噢	噢 😐️ 😮️
四	四 4️⃣
囧	囧 😅️ 😰️ （´Д`）
困	困 😪 🥱
圆	圆 ⭕️
土	土 ㊏ ㈯
地	地 ⏚
坎	坎 ☵
坑	坑 🕳
坛	坛 ⚱️
坞	坞 ⚓️
坟	坟 ⚰️ 🪦
坤	坤 ☷
埃	埃 Å
塔	塔 🗼
墓	墓 🪦
声	声 🈤
壶	壶 🫖
夏	夏 🀧
多	多 🈕
夜	夜 🌃️ ㊰
天	天 🈗
奖	奖 🏅 🎖 🏆
女	女 ♀
奶	奶 🥛
她	她 👤️
好	好 👌 👍 🙆‍♂️ 🙆‍♀️
妃	妃 👸🏻️
妈	妈 👩🏻️
妻	妻 👰🏻‍♀️
姜	姜 🫚
娃	娃 👶🏻️
婗	婗 👧🏻️
婴	婴 👶🏻️
字	字 🈑
学	学 ㊫ ㈻
宅	宅 🏠️ 🤓
安	安 🉃 ㎀ ㎁ ㎂ ㎃ ㎄
宗	宗 ㊪
家	家 🏠
对	对 ✅ ✔
小	小 🤏 🤌
少	少 🤏 🤌
尺	尺 📏️ 📐
屁	屁 😛️
屋	屋 🏠️ 🏘 🏡
屎	屎 💩
山	山 ⛰️
岛	岛 🏝️
巢	巢 🪹 🪺
左	左 ⬅️ ←
差	差 👎🏻️
巽	巽 ☴
帆	帆 ⛵️
帕	帕 ㎩ ㍱ ㎪ ㎫ ㎬
帚	帚 🧹
帽	帽 🎩
干	干 ☰
并	并 ∪
幼	幼 ㉅
床	床 🛏
庙	庙 🛕
度	度 ° ℃ ℉
弓	弓 🏹️
弧	弧 ⌒
弱	弱 👎 (。・・)ノ
强	强 👍
得	得 🉐
心	心 ♥️
怒	怒 😡 😠 💢
怕	怕 😟
惊	惊 🗯️ 😨 😱
惨	惨 😦️ 😫️
想	想 💭
憨	憨 🐷️
懒	懒 _(:3」∠)_
或	或 ∨
戟	戟 🔱
户	户 🪟
扇	扇 🪭
手	手 ✋
扑	扑 (/≧▽≦)/
打	打 🈱
托	托 🫴🏻
找	找  🔍 🔎
抓	抓 🫳🏻 W(￣_￣)W
投	投 🈧
抖	抖 😨 😱
折	折 乛 乚 亅
抱	抱 🫂
拖	拖 ヽ(゜▽゜)－C<(/;◇;)/~
拜	拜 🙏
拳	拳 👊
拿	拿 🫳🏻
指	指 🈯
捏	捏 🤏🏻 🤌🏻
捕	捕 🈨
捧	捧 🤲🏻
捺	捺 丶
推	推 🫸 🫷
掬	掬 🤲🏻
撇	撇 丿
撮	撮 🤌🏻
操	操 🖕 凸(艹皿艹)
文	文 ㉆
料	料 🈛
斧	斧 🪓
斩	斩 ˋ(°▽、°)(o(￣▽￣///(斩!!)
新	新 🆕
无	无 🈚️
日	日 ☀️
星	星 ⭐️ * ⁑ *️⃣
映	映 🈙
春	春 🀦
晕	晕 😵 😵‍💫
晴	晴 ☀️
月	月 🈷️
有	有 🈶
朔	朔 🌑️
木	木 🪵 ㊍ ㈭
本	本 🉀
杖	杖 🦯
杧	杧 🥭
杯	杯 🫗
枝	枝 🌿️
枪	枪 🔫 ▄︻┻┳═一…… (╬ﾟдﾟ)▄︻┻┳═一 ▄︻┻┳═一……☆（>○<） ▄︻┻┳═一∵∴∷∶∵(∵_,∵)>>>>
枫	枫 🍁️
枭	枭 🦉
柴	柴 🪵
树	树 🌳
栗	栗 🌰️
株	株 ㊑ ㈱
桃	桃 🍑
桥	桥 🌉
桶	桶 🪣 🛢 🗑
梅	梅 🀢
梦	梦 💭️
梨	梨 🍐
梯	梯 🪜
梳	梳 🪮
棒	棒 👍
棺	棺 ⚰️
椅	椅 💺️ 🪑
椰	椰 🥥
横	横 一
樽	樽 🏺️
橙	橙 🟧
欧	欧 ㏀ ㏁
正	正 ✔️ + ㊣
段	段 ¶ ⁋
母	母 👩🏻️
比	比 🆚
求	求 🥺
汗	汗 😅 😰 😓
汤	汤 🥣
泡	泡 🫧
注	注 ㊟
泪	泪 😭️ 😢 🥲
洞	洞 🕳
派	派 🥧
浪	浪 🌊
海	海 🌊️
涨	涨 🆙️ 📈️
渔	渔 🎣️
游	游 🈫
満	満 🈵️
溅	溅 💦️
滚	滚 😛️ 🤬 (ノ｀Д)ノ滚~
满	满 🈵
演	演 🈦
火	火 🔥
灯	灯 💡
烂	烂 👎🏻️
烟	烟 🚬
烦	烦 😒 🤯
烫	烫 🥵
热	热 🥵
熊	熊 🐻
爪	爪 🫳🏻 🐾
爱	爱 ♥️
父	父 👨🏻️
爸	爸 👨🏻️
爽	爽 ☺️
牙	牙 🦷
牛	牛 🐮
特	特 ㊕ ㈵
犀	犀 🦏
犬	犬 🐕
狐	狐 🦊
狗	狗 🐶 🐕
狮	狮 🦁
狸	狸 🦫
狼	狼 🐺
猥	猥 🦔
猪	猪 🐷 🐖
猫	猫 🐱
猴	猴 🐵 🐒
猿	猿 🦧
獾	獾 🦡
王	王 🫅🏻
球	球 ⚽️
琴	琴 🎹️
瓦	瓦 ㎺ ㎻ ㎼ ㎽ ㎾ ㎿ ㍗
瓶	瓶 🫙
生	生 🈢
申	申 🈸
电	电 ⚡️
男	男 ♂
画	画 🎨️ 🖼
白	白 ⬜️
百	百 佰
皂	皂 🧼
盐	盐 🧂
监	监 ㊬ ㈼
盔	盔 🪖
盗	盗 🉆
盘	盘 💽 💾 💿 📀
目	目 👁️
盯	盯 👁️
盲	盲 🧑🏻‍🦯
盾	盾 🛡️
看	看 👀
眼	眼 👀 👁
瞎	瞎 👨‍🦯
瞧	瞧 👀 |･ω･｀)
石	石 🪨
砖	砖 🧱
硴	硴 🦪
碗	碗 🥣
社	社 ㊓ ㈳
祝	祝 ㊗️
票	票 🎫️
祭	祭 ㉀
禁	禁 🈲
离	离 ☲
秃	秃 🧑🏻‍🦲
秋	秋 🀨
秒	秒 ″ ‴ 〃 ㎰ ㎱ ㎲ ㎳
秘	秘 ㊙️
秤	秤 ⚖️
积	积 ∏
稍	稍 🤌🏻
稻	稻 🌾️
空	空 🈳
窗	窗 🪟
窘	窘 😅️
窥	窥 🫣
竖	竖 丨 |
站	站 🧍🏻
竹	竹 🎍️ 🀤
笑	笑 😄 😊
笔	笔 ✏ ✒ 🖋 🖊
笛	笛 🪈
笨	笨 (～￣(OO)￣)ブ (っ*´Д`)っ
筝	筝 ㉇
筷	筷 🥢
签	签 🏷️
箫	箫 🪈
箭	箭 🏹️
箱	箱 📦
箸	箸 🥢
篮	篮 🧺
米	米 ㎙ ㎚ ㎛ ㎜ ㎝ ㎞ ㍍
粪	粪 💩️
糖	糖 🍬
紫	紫 🟪
累	累 🥱
红	红 🟥
约	约 ≈
纸	纸 📄
线	线 🧵 🧶
终	终 🈡
结	结 🪢
绳	绳 🪢
绿	绿 🟩
罐	罐 🫙 🏺
网	网 🕸️
羊	羊 🐑
羞	羞 😚️ 🙈️
羽	羽 🪶
翅	翅 🪽
翼	翼 🪽
老	老 🧓🏻
耳	耳 👂
耶	耶 ✌️
聋	聋 🧏🏻 🦻🏻
肉	肉 🍖 🥩
肌	肌 💪🏻
肏	肏 🤬
肺	肺 🫁
胜	胜 🉇
胡	胡 🧔🏻
胫	胫 🦵🏻
脑	脑 🧠
脚	脚 🦶
脷	脷 👅️
腿	腿 🦵
自	自 ㉂
舌	舌 👅
舞	舞 💃🏻️
舵	舵 ☸️
船	船 🚢
艮	艮 ☶
色	色 😍
节	节 §
花	花 🌷
苗	苗 🌱️
苯	苯 ⌬ ⏣
茄	茄 🍆️
茶	茶 🍵
草	草 🌿️
药	药 💊️
莲	莲 🪷
菊	菊 🌼️ 🀥
菌	菌 🍄️
菜	菜 🥬
萌	萌 💠️ 😊️
营	营 🈺
蒜	蒜 🧄
蓝	蓝 🟦
藻	藻 🦠
虎	虎 🐯
虫	虫 🐛 🪱
虹	虹 🌈️
虺	虺 🐍️
虾	虾 🦐
蚁	蚁 🐜️
蚊	蚊 🦟
蚝	蚝 🦪
蛇	蛇 🐍
蛋	蛋 🥚
蛔	蛔 🪱
蛙	蛙 🐸️ 𓆏
蛛	蛛 🕷️
蛤	蛤 🐸
蛸	蛸 🐙️
蜂	蜂 🐝️
蜇	蜇 🪼
蜗	蜗 🐌️
蜜	蜜 🍯️
蜥	蜥 🦎
蝇	蝇 🪰
蝎	蝎 🦂️
蝠	蝠 🦇
蝶	蝶 🦋
螺	螺 🐚️
蟹	蟹 🦀
蠕	蠕 🪱
蠢	蠢 🐷️ 🤪
血	血 🩸
行	行 👌
表	表 ⌚️
袜	袜 🧦
装	装 🥸
裇	裇 👕️ 👚️
裙	裙 👗️
裤	裤 👖️
西	西 🀂
角	角 ∠
解	解 🈖
误	误 ✖️
说	说 🗣 👄
诶	诶 🤨
请	请 💁🏻
豆	豆 🫘 🫛
豌	豌 🫛
豕	豕 🐖️
象	象 🐘️ 🦣 𓃰
豸	豸 🐈️
豹	豹 🐆
貂	貂 🦡
贝	贝 🐚️
负	负 -
财	财 ㊖ ㈶
败	败 🉈
货	货 🚚️
贩	贩 🈣
贪	贪 🤑
资	资 ㊮ ㈾
赖	赖 ᕕ(ᐛ)ᕗ
赞	赞 👍
赤	赤 🟥
走	走 🚶🏻
足	足 🦶
跌	跌 📉️
跑	跑 🏃🏻 💨 ε=ε=ε=(~￣▽￣)~
跛	跛 🧑🏻‍🦼 🧑🏻‍🦽
跪	跪 🧎🏻 ○|￣|_ _|￣|○
路	路 🛣
踢	踢 🦶
踩	踩 🦶
车	车 🚗️ 🚘
轮	轮 🛞
辣	辣 🥵
适	适 ㊜
逃	逃 🏃‍ 💨 ε=ε=ε=┏(゜ロ゜;)┛
逆	逆 ¬
酒	酒 🍷
酷	酷 🆒
醉	醉 🥴 （〃｀3′〃）
金	金 ㊎ ㈮
针	针 🪡
钉	钉 📌 📍 📎
钗	钗 🪮
钩	钩 🪝
钱	钱 💰
铃	铃 🔔 🔕
锁	锁 🔒 🔓
锄	锄 ⛏️ ⚒
错	错 ❌ ❎
锚	锚 ⚓
锤	锤 🔨️
锯	锯 🪚
镐	镐 ⛏️
镜	镜 🪞
门	门 🚪
闻	闻 👃
阴	阴 🌥️
除	除 ➗
难	难 😵‍💫
雨	雨 🌧
雪	雪 ❄️
零	零 0️⃣
雷	雷 🌩️ ⚡
雾	雾 🌫
震	震 ☳
霾	霾 🌫
青	青 🟦
靠	靠 😧️
面	面 🍜 🍝
靴	靴 👢️
鞋	鞋 👞
页	页 ㌻
顶	顶 🆙
项	项 ㊠
须	须 🧔🏻
额	额 😢️ 😥️ 😿️
风	风 💨️ 🌬
饭	饭 🍚
饵	饵 🪤
饺	饺 🥟
饼	饼 🫓
饿	饿 😋 🤤
馋	馋 😋️ 🤤
馕	馕 🥙
马	马 🐴 🐎
驴	驴 🫏
驿	驿 🚉️
骂	骂 🤬
骗	骗 🤥
骨	骨 🦴 💀
髯	髯 🧔🏻
鬼	鬼 👻
魂	魂 👻️
鮨	鮨 🍣️
鱡	鱡 🦑
鱼	鱼 🐟
鲗	鲗 🦑
鲨	鲨 🦈
鲸	鲸 🐋️ 🐳
鳄	鳄 🐊️
鸟	鸟 🐦
鸡	鸡 🐔
鸭	鸭 🦆
鸮	鸮 🦉
鸽	鸽 🕊️ 🐦
鹅	鹅 🪿
鹰	鹰 🦅
鹿	鹿 🦌
麋	麋 🫎
麦	麦 🎙️ 🎤️
黄	黄 🟨
黑	黑 ⬛️
鼓	鼓 🥁
鼔	鼔 🥁
鼠	鼠 🐭
鼬	鼬 🦨
鼻	鼻 👃
齿	齿 🦷
龙	龙 🐲 🐉
龟	龟 🐢
𪠳	𪠳 🤪
𪡃	𪡃 😟️
𫙠	𫙠 🐬️
唱K	唱K 🪩
开party	开party 🥳
㞎㞎	㞎㞎 💩️
䲡鱼	䲡鱼 🦑
一个	一个 ☝️
一人	一人 👤️
一壶	一壶 🫖
一定	一定 🙆🏻
一撮	一撮 🤌🏻
一杯	一杯 🥃
一滴	一滴 💧
一点	一点 🤏 🕐
一百	一百 💯
一齐	一齐 🧑🏻‍🤝‍🧑🏻
七夕	七夕 🎋
七点	七点 🕖
万分	万分 ‱
万岁	万岁 🙌🏻！*★,°*:.☆(￣▽￣)/$:*.°★*。
丈夫	丈夫 🤵🏻‍♂️
三十	三十 卅 〺
三点	三点 🕒
三角	三角 🔺 🔻
上下	上下 ↕️ ↕
上升	上升 📈
上午	上午 ㏂
上头	上头 👆🏻️
上弦	上弦 🌓 🌛
上映	上映 📽
上涨	上涨 📈
上衣	上衣 👕
上课	上课 🧑🏻‍🏫
上边	上边 👆
上锁	上锁 🔒
上面	上面 👆
下午	下午 ㏘
下厨	下厨 👨‍🍳 👩‍🍳
下头	下头 👇🏻️
下弦	下弦 🌗 🌜
下跌	下跌 📉
下跪	下跪 🧎🏻
下边	下边 👇
下降	下降 📉
下雨	下雨 🌧
下雪	下雪 🌨 ❄️
下面	下面 👇
不丹	不丹 🇧🇹
不会	不会 😝️
不信	不信 😓️ 😳️
不准	不准 🚫
不听	不听 🙉
不哭	不哭 🤗️
不女	不女 🙅🏻‍♀️
不好	不好 👎
不屑	不屑 😒 🫤 (￣_,￣)
不干	不干 😝️ 🙅🏻
不强	不强 👎
不得	不得 🚫️
不悦	不悦 🙁
不懂	不懂 😕
不棒	不棒 👎
不满	不满 🙁
不爽	不爽 ☹️
不男	不男 🙅🏻‍♂️
不看	不看 🙈
不等	不等 ≠
不管	不管 🤷🏻
不行	不行 🙅‍♂️ 🙅‍♀️
不要	不要 😣️
不见	不见 😣️
不解	不解 🤔
不讲	不讲 🤐️
不许	不许 🚫
不说	不说 🤐 🙊
不通	不通 ⛔️ 🚧️
不错	不错 👍
专家	专家 🧑🏻‍🔬
世界	世界 🌐️ 🗺
东京	东京 🗻️
东加	东加 🇹🇴
丝带	丝带 🎗
両替	両替 💱️
丢脸	丢脸 🤦‍
两个	两个 ✌️
两人	两人 👥️
两仪	两仪 ☯️
两点	两点 🕑
严禁	严禁 🚫 🈲
严肃	严肃 (･᷄ὢ･᷅)
丧尸	丧尸 🧟‍♂️ 🧟‍♀️
中产	中产 🧑🏻‍💼
中国	中国 🇨🇳
中学	中学 🏫️
中指	中指 🖕
中秋	中秋 🎑
中药	中药 🌿
中非	中非 🇨🇫
丰收	丰收 🎑️
串串	串串 🍢
串烧	串烧 🍢️
丸子	丸子 🍡️
丹麦	丹麦 🇩🇰
为何	为何 🤔️
为啥	为啥 🤔️
主厨	主厨 🧑🏻‍🍳
主意	主意 💭️
举手	举手 🙋‍♂️ 🙋‍♀️
举重	举重 🏋️‍♂️ 🏋️‍♀️
举铁	举铁 🏋🏻
么么	么么 💋
义体	义体 🦾 🦿
义气	义气 ヽ(￣ω￣(￣ω￣〃)ゝ
义肢	义肢 🦾 🦿
乌贼	乌贼 🦑
乌鸦	乌鸦 🐦‍⬛
乌龟	乌龟 🐢
乍得	乍得 🇹🇩
乐曲	乐曲 🎼️
乐谱	乐谱 🎼
乒乓	乒乓 🏓️
乔装	乔装 🥸
乖宝	乖宝 👶
乘以	乘以 ✖️
乘号	乘号 ✖️
乘积	乘积 ∏
九点	九点 🕘
也门	也门 🇾🇪
习题	习题 📖️
书写	书写 ✍🏻️
书包	书包 🎒
书卷	书卷 📜️
书本	书本 📖 📚
书签	书签 🔖
书籍	书籍 📖 📚
乱噏	乱噏 🤥
乱码	乱码 ~%?…,#*'☆&℃$︿★?
乱讲	乱讲 🤥
乳液	乳液 🧴
乳酪	乳酪 🧀
二十	二十 廿 〹
云中	云中 😶‍🌫️
云彩	云彩 ☁️
云朵	云朵 ☁️
五指	五指 🖐🏻️
五点	五点 🕔
五谷	五谷 稻 黍（黍米） 稷（小米） 麦 菽（大豆） 麻（大麻）
井号	井号 #️⃣
亚军	亚军 🥈
亚洲	亚洲 🌏
交集	交集 ∩
享受	享受 ☺️
亮度	亮度 🔅 🔆
亮蛋	亮蛋 🧑🏻‍🦲
亲亲	亲亲 😘
亲吻	亲吻 💋
亲嘴	亲嘴 💋
亲爱	亲爱 😚️
人猿	人猿 🦧
人鱼	人鱼 🧜‍♂️ 🧜‍♀️
什么	什么 🤔 (´◔‸◔`)？
仓鼠	仓鼠 🐹
仔细	仔细 🧐
他们	他们 👥️
仙人	仙人 🧚🏻
仙女	仙女 🧚🏻‍♀️
仙子	仙子 🧚🏻‍♂️
仙贝	仙贝 🍘
令和	令和 ㋿
仲秋	仲秋 🌕️ 🎑️
价钱	价钱 💲
任意	任意 ∀
企女	企女 🧍🏻‍♀️
企男	企男 🧍🏻‍♂️
企鹅	企鹅 🐧
伊朗	伊朗 🇮🇷
伏特	伏特 ㎴ ㎵ ㎶ ㎷ ㎸ ㎹
休息	休息 😑️
休达	休达 🇪🇦
伞兵	伞兵 🪂
伞状	伞状 ☂️
传真	传真 📠
伤了	伤了 🤕️
伤心	伤心 💔
伪装	伪装 🥸
估吓	估吓 😏️
伸手	伸手 🫴
低头	低头 (。﹏。)
低温	低温 🥶
低落	低落 😞
住宅	住宅 🏠
住宿	住宿 🛌🏻️
住店	住店 🛌🏻️
佐料	佐料 🧂
体操	体操 🤸🏻
体积	体积 ㎣ ㎤ ㎥ ㎦ ㎕ ㎖ ㎗ ㎘ ㍑
佛堂	佛堂 🛐️
佛寺	佛寺 🛕
佛殿	佛殿 🛐️
佛珠	佛珠 📿️
作弄	作弄 😜️
作曲	作曲 🎼️
你好	你好 👋
你妈	你妈 🤬
你妹	你妹 🤬
你猜	你猜 😏️ 😼️
侦探	侦探 🕵️‍♂️ 🕵️‍♀️
便便	便便 💩
便当	便当 🍱
便条	便条 📝️
便笺	便笺 📝
便餐	便餐 🥡
俄国	俄国 🇷🇺
保密	保密 🤐
保龄	保龄 🎳️
信件	信件 ✉️
信号	信号 📶
信封	信封 ✉️
信息	信息 ℹ
信箱	信箱 📪
倒带	倒带 ⏪️
倒彩	倒彩 🖕🏻️
倒楣	倒楣 😫️
倒水	倒水 🫗
倒脸	倒脸 🙃
倒退	倒退 ◀️
倒霉	倒霉 😓
倾倒	倾倒 🫗
假肢	假肢 🦾 🦿
假话	假话 🤥
假面	假面 🎭️ 🥸
做梦	做梦 💭️ ZZzz…(。-ω-)..ooO((【•:*:~梦~:*:•】))
做饭	做饭 👨‍🍳 👩‍🍳
停止	停止 ⏹️
停车	停车 🅿️
健身	健身 💪
偷看	偷看 🫣
偷瞄	偷瞄 🫣
偷瞧	偷瞧 🫣
偷窥	偷窥 🫣 ┬┴┤_•)
偷笑	偷笑 😏️ 🤭
傍晚	傍晚 🌆
傲慢	傲慢 😤
傻冒	傻冒 🐷️
傻屄	傻屄 🐷️
傻瓜	傻瓜 🤪
傻笑	傻笑 😆
傻逼	傻逼 🤬
僵尸	僵尸 🧟‍♂️ 🧟‍♀️
儿子	儿子 👦
儿童	儿童 🧒
元宵	元宵 ⚪
兄妹	兄妹 👫🏻
兄弟	兄弟 👬
充电	充电 🔋️ 🔌
先生	先生 🤵🏻‍♂️
光头	光头 👨‍🦲 👩‍🦲 🦲
光明	光明 🌞️
光环	光环 😇
光盘	光盘 💽
光碟	光碟 💽
免费	免费 🆓
兑换	兑换 💱
兔头	兔头 🐰
兔女	兔女 👯🏻‍♀️
兔子	兔子 🐰 🐇
兔年	兔年 🐰️
兔男	兔男 👯🏻‍♂️
兔肉	兔肉 🐇️
兔脸	兔脸 🐰
全家	全家 👪
全新	全新 🆕
全等	全等 ≅
八点	八点 🕗
公主	公主 👸
公交	公交 🚌
公园	公园 ⛲
公放	公放 📢️
公牛	公牛 🐂
公羊	公羊 🐏
公路	公路 🛣
公车	公车 🚌 🚍
公顷	公顷 ㌶
公鸡	公鸡 🐓
六点	六点 🕕
关岛	关岛 🇬🇺
关机	关机 📴
兴奋	兴奋 😳 (p≧w≦q)
养神	养神 😑️
养鱼	养鱼 🐠️
兽人	兽人 🧌
内衣	内衣 👙
内裤	内裤 🩲
再见	再见 👋
冒号	冒号 ： :
冒汗	冒汗 😅 😰 😓
冒泡	冒泡 🫧
写作	写作 ✍🏻️
写信	写信 ✉️
写字	写字 ✍️
军人	军人 🪖
军盔	军盔 🪖
农夫	农夫 👨‍🌾
农妇	农妇 👩‍🌾
农户	农户 🧑🏻‍🌾
农民	农民 👨‍🌾 👩‍🌾
冠军	冠军 🏆
冥想	冥想 🧘‍♂️ 🧘‍♀️
冰冷	冰冷 🥶
冰刀	冰刀 ⛸️
冰块	冰块 🧊
冰壶	冰壶 🥌
冰岛	冰岛 🇮🇸
冰沙	冰沙 🍧
冰球	冰球 🏒
冰鞋	冰鞋 ⛸️
冲凉	冲凉 🚿️
冲浪	冲浪 🏄‍♂️ 🏄‍♀️
冷汗	冷汗 😅 😰 😓
冷漠	冷漠 😶️
冷笑	冷笑 😏️ （￣ー￣）
冷脸	冷脸 🥶
冷饮	冷饮 🍹
冻僵	冻僵 🥶
准确	准确 🎯️
凉爽	凉爽 🆒
凉鞋	凉鞋 🩴 👡
凋谢	凋谢 🥀
凋零	凋零 🥀
减号	减号 ➖
减少	减少 📉
凤梨	凤梨 🍍
凭据	凭据 🧾
凭条	凭条 🧾
凳子	凳子 🪑
出丑	出丑 🤡
出国	出国 💱
出拳	出拳 👊
出汗	出汗 🥵 😓 💦
出海	出海 🚢️
出游	出游 🚙️
出窍	出窍 0(:3)～=͟͟͞͞('､3)_ヽ)＿
出色	出色 🤩
出警	出警 🚨️
击中	击中 🎯️
击剑	击剑 🤺
击掌	击掌 ✋
刀叉	刀叉 🍴
分号	分号 ； ;
分手	分手 💔️
分裂	分裂 分＞(￣▽￣=￣︿￣)<裂
分贝	分贝 ㏈
划船	划船 🚣‍♂️ 🚣‍♀️
划艇	划艇 🚣‍♂️ 🚣‍♀️
列车	列车 🚄 🚅
刚果	刚果 🇨🇩 🇨🇬
初中	初中 🏫️
删除	删除 🆑 ⌫
刨冰	刨冰 🍧
利是	利是 🧧
别墅	别墅 🏡
别说	别说 🫢
别走	别走 _____λ......___丬别走啊～～
别针	别针 🧷
刷新	刷新 ⟲
刷牙	刷牙 🪥
刺猥	刺猥 🦔
刺猬	刺猬 🦔
剃刀	剃刀 🪒
剃头	剃头 💇🏻
剪刀	剪刀 ✂️
剪发	剪发 💇‍♂️ 💇‍♀️
剪头	剪头 💇‍♂️ 💇‍♀️
剪子	剪子 ✂️
剪影	剪影 👤
剪辑	剪辑 🎬️
力量	力量 💪 🦾 ┗|*｀0′*|┛
功率	功率 ㎺ ㎻ ㎼ ㎽ ㎾ ㎿
加冕	加冕 🫅🏻
加冰	加冰 🧊
加减	加减 ± ∓
加号	加号 ➕
加密	加密 🔐️
加彭	加彭 🇬🇦
加油	加油 ⛽
加纳	加纳 🇬🇭
加蓬	加蓬 🇬🇦
动车	动车 🚄 🚅
努力	努力 💪
劳作	劳作 ⚒️
劳动	劳动 ⚒️
劳工	劳工 👨🏻‍🏭 🧑🏻‍🏭
势利	势利 🤑️
勋章	勋章 🎖
勺子	勺子 🥄
勾选	勾选 ✅ ✔
勿扰	勿扰 🔕️
包包	包包 👜
包含	包含 ⊂ ⊃ ⊆ ⊇
包米	包米 🌽️
包装	包装 🎁
包裹	包裹 📦
包谷	包谷 🌽️
匕手	匕手 🗡️
匕首	匕首 🗡
化妆	化妆 🥸
化学	化学 ⚗️
北韩	北韩 🇰🇵
匙子	匙子 🥄
医学	医学 ⚕️
医生	医生 👨‍⚕️ 👩‍⚕️
医疗	医疗 ⚕️
医者	医者 🧑🏻‍⚕️
医院	医院 🏥
匿名	匿名 👤️
十一	十一 Ⅺ ⅺ ⑪
十二	十二 Ⅻ ⅻ ⑫
十点	十点 🕙
千克	千克 ㎏
千分	千分 ‰
千米	千米 ㎞ ㏎
升号	升号 ♯
升级	升级 🆙
半夜	半夜 🌃
半月	半月 🌓️
华夫	华夫 🧇
单曲	单曲 🔂
单板	单板 🏂🏻️
单眼	单眼 👁
单车	单车 🚲
单轨	单轨 🚝
单选	单选 🔘
卖艺	卖艺 🤹🏻
卖萌	卖萌 💠️ 😊️ 🥰
南帽	南帽 🎩️
南极	南极 🇦🇶
南瓜	南瓜 🎃️
南非	南非 🇿🇦
南韩	南韩 🇰🇷
博士	博士 🧑🏻‍🎓
占卜	占卜 🔮
卡车	卡车 🚛
卡达	卡达 🇶🇦
卤煮	卤煮 🍢️
卫兵	卫兵 💂‍♂️ 💂‍♀️
卫士	卫士 💂‍♂️ 💂‍♀️
卫星	卫星 🛰
卫门	卫门 💂🏻
印尼	印尼 🇮🇩
印度	印度 🇮🇳
危楼	危楼 🏚
危险	危险 ⚠️
卷发	卷发 👨‍🦱 👩‍🦱 🦱
卷烟	卷烟 🚬
卷纸	卷纸 🧻
卷虾	卷虾 🍤️
卷轴	卷轴 📜
卷饼	卷饼 🌮 🌯
厉害	厉害 👍
压力	压力 ㎩ ㍱ ㎪ ㎫ ㎬
压强	压强 ㎩ ㍱ ㎪ ㎫ ㎬
压缩	压缩 🗜️
厌恶	厌恶 🙄 🙃
厕所	厕所 🚻 🚾
厘米	厘米 ㎝
原子	原子 ⚛️
原木	原木 🪵
厨子	厨子 🧑🏻‍🍳
厨师	厨师 👨‍🍳 👩‍🍳
去死	去死 (-__-)=@))>o<)
参禅	参禅 🧘🏻
参考	参考 ※
叉叉	叉叉 ❌ ❎
叉梳	叉梳 🪮
友谊	友谊 🤝🏻
双人	双人 👥
双剑	双剑 ⚔️
双手	双手 🤲
双板	双板 ⛷️
双目	双目 👀️
双眼	双眼 👀️
双胞	双胞 👨‍👩‍👦‍👦 👨‍👩‍👧‍👦 👨‍👩‍👧‍👧
反对	反对 🙅‍♂️ 🙅‍♀️
反派	反派 🦹‍♂️ 🦹‍♀️
反胃	反胃 🤢
发件	发件 📤
发信	发信 📤
发卡	发卡 🪮
发型	发型 💇
发抖	发抖 😨 😱
发梦	发梦 💭️
发火	发火 😡
发烧	发烧 🤒
发热	发热 🥵
发狂	发狂 🤯
发票	发票 🧾
发芽	发芽 🌱
发言	发言 💬️
发誓	发誓 ✊🏻️
发财	发财 🤑
发钗	发钗 🪮
发飙	发飙 😡
取款	取款 🏧️
取钱	取钱 🏧️
受伤	受伤 🤕 ❤️‍🩹
变性	变性 ⚧
变装	变装 🥸
口岸	口岸 🛂️
口水	口水 🤤
口红	口红 💄
口罩	口罩 😷
古堡	古堡 🏰️
古巴	古巴 🇨🇺
句号	句号 。 .
可乐	可乐 🥤
可以	可以 🙆‍♂️ 🙆‍♀️ 🉑
可怕	可怕 😨
可怜	可怜 🥺
可恶	可恶 （＝。＝） (〃＞目＜)
可惜	可惜 😮‍💨
可爱	可爱 ☺️ 🥰
可真	可真 😓️
可能	可能 🤔
台历	台历 📆️
台湾	台湾 🇹🇼
台球	台球 🎱
台钟	台钟 🕰
台风	台风 🌀
右上	右上 ↗️ ↗
右下	右下 ↘️ ↘
右前	右前 ↗️
右后	右后 ↘️
右手	右手 🫱 🫸
右拳	右拳 🤛
右推	右推 🫸
右边	右边 👉
右面	右面 👉
叶子	叶子 🍃
叶门	叶门 🇾🇪
司南	司南 🧭
叹号	叹号 ❗ ❕
叹惜	叹惜 😮‍💨
叹气	叹气 😮‍💨
叻仔	叻仔 🤩
叻女	叻女 🤩
吃吧	吃吧 😋️
吃惊	吃惊 😱
吃瓜	吃瓜 [吃瓜]
吃糖	吃糖 🍬
吃肉	吃肉 🍖
吃面	吃面 🍜
吃饭	吃饭 🍚️ ψ(｀∇´)ψ (((((ヾ(o=^•ェ•)o┏━┓
合什	合什 🙏🏻️
合作	合作 🤝
合十	合十 🙏
合掌	合掌 🙏
合格	合格 🈴
吉他	吉他 🎸
吉士	吉士 🍮️
吉它	吉它 🎸️
吊牌	吊牌 🏷
同学	同学 🧑🏻‍🎓
同志	同志 👬🏻️
同意	同意 🙆‍♂️ 🙆‍♀️
吐了	吐了 🤮
吐司	吐司 🍞️
吐舌	吐舌 😛 😜 😝
向上	向上 👆
向下	向下 👇
向右	向右 👉
向左	向左 👈
吓人	吓人 👻
吓死	吓死 😦
吕宋	吕宋 🇵🇭
君主	君主 🫅
含泪	含泪 🥹
含蓄	含蓄 ☺️
吸把	吸把 🪠
吸气	吸气 🫁
吸烟	吸烟 🚬
吹拂	吹拂 🌬
吹气	吹气 🌬️
吹风	吹风 🌬
吻你	吻你 😘️ 😙️ 😽️
吻痕	吻痕 💋
呆子	呆子 🤓
呆滞	呆滞 😳
告状	告状 (σ'ω')σ ～(TロT)σ
呕吐	呕吐 🤮
呜呜	呜呜 😖️
呲牙	呲牙 😁️
呵呵	呵呵 🙂 🙃
呵护	呵护 🤲🏻
呵欠	呵欠 🥱
呼吸	呼吸 👃
呼机	呼机 📟
呼气	呼气 😮‍💨 🫁
命中	命中 🎯
和尚	和尚 👨‍🦲
和平	和平 ☮️
和服	和服 👘
咒骂	咒骂 🤬
咖啡	咖啡 ☕
咖喱	咖喱 🍛
咧嘴	咧嘴 😁️
咨询	咨询 ℹ️
咬唇	咬唇 🫦
咬牙	咬牙 😬
哀悼	哀悼 💮️
哆嗦	哆嗦 🥶
哇哦	哇哦 😃️ 😯️
哇喔	哇喔 😯️
哈哈	哈哈 😄
哈欠	哈欠 🥱
哈雷	哈雷 ☄️
响指	响指 🫰
响铃	响铃 🔔️
哥俩	哥俩 👬🏻️
哥哥	哥哥 🧍‍♂️
哥妹	哥妹 👫🏻️
哥弟	哥弟 👬🏻️
哦哦	哦哦 😀️
哦耶	哦耶 ✌️
哭泣	哭泣 😢
哭笑	哭笑 😂️ 😹️
哺乳	哺乳 🤱 👩‍🍼
唇印	唇印 💋
唇彩	唇彩 💄️
唇膏	唇膏 💄
唔明	唔明 😵‍💫 😵️
唔知	唔知 😲️ 🤷🏻
唱歌	唱歌 🎤️
商场	商场 🏬
商店	商店 🏪
商标	商标 ™
商贩	商贩 👲🏻️
商超	商超 🏬
啊嚏	啊嚏 🤧
啤酒	啤酒 🍺
啥啊	啥啊 😲️
喂奶	喂奶 🤱
喇叭	喇叭 📢 📣
喊话	喊话 🗣️
喔耶	喔耶 ✌🏻️
喜欢	喜欢 😍 ♥️
喜爱	喜爱 😻️
喝多	喝多 🥴
喝奶	喝奶 🍼
喝醉	喝醉 🥴
喝采	喝采 🥳
喧哗	喧哗 🗣️
喵喵	喵喵 🐱
喷嚏	喷嚏 🤧
喷头	喷头 🚿
喷气	喷气 💨️
喷水	喷水 🐳
喷泉	喷泉 ⛲
嗯哼	嗯哼 🫤
嗯嗯	嗯嗯 😀️ 嗯~o(*￣▽￣*)o
嘎嘎	嘎嘎 🦆
嘚瑟	嘚瑟 ～(￣▽￣～)~
嘟嘴	嘟嘴 😗️
嘲笑	嘲笑 😝
嘴唇	嘴唇 👄
嘴巴	嘴巴 👄
嘻嘻	嘻嘻 😁
嘿嘿	嘿嘿 😁
噘嘴	噘嘴 😗 🙎‍♂️ 🙎‍♀️
噢噢	噢噢 😀️
噢耶	噢耶 ✌🏻️
四点	四点 🕓
回家	回家 『家』～o(▽｀o)=3=3=3
回收	回收 ♻️
回族	回族 ☪️ 🧕🏾
回民	回民 ☪️ 🧕🏾
回车	回车 ↩️
因为	因为 ∵
团子	团子 🍡
困乏	困乏 😪
困了	困了 😪 🥱
困倦	困倦 😪 🥱
困困	困困 😪
困惑	困惑 😕
困扰	困扰 😕
困觉	困觉 😴️
围巾	围巾 🧣
围棋	围棋 ⚫ ⚪
围脖	围脖 🧣
围颈	围颈 🧣
固话	固话 ☎️
国宝	国宝 🐼
国王	国王 🤴
国际	国际 🌐️
图书	图书 📖 📚
图表	图表 📊
图钉	图钉 📌
圆圈	圆圈 ⭕
圆形	圆形 ⚫ ⚪
圆月	圆月 🌕 🌝
圆桶	圆桶 🪣
圈七	圈七 ⑦ ⓻ ➐ ㊆
圈三	圈三 ③ ⓷ ❸ ㊂
圈九	圈九 ⑨ ⓽ ➒ ㊈
圈二	圈二 ② ➋ ⓶ ㊁
圈五	圈五 ⑤ ➎ ⓹ ㊄
圈八	圈八 ⑧ ❽ ⓼ ㊇
圈六	圈六 ⑥ ⓺ ❻ ㊅
圈十	圈十 ⑩ ⓾ ⒑ ➓ ㊉
圈四	圈四 ④ ❹ ⓸ ㊃
圈圈	圈圈 ⭕️
土星	土星 🪐
土豆	土豆 🥔
土豪	土豪 💰️
圣堂	圣堂 ⛪
圣婴	圣婴 👼🏻
圣诞	圣诞 🎅 🤶 🧑‍🎄
在建	在建 🏗️
地主	地主 👲
地图	地图 🗺️ 🗾
地球	地球 🌏
地瓜	地瓜 🍠
地铁	地铁 🚇 Ⓜ️
场记	场记 🎬
坎达	坎达 🪯
坏人	坏人 🦹‍
坏笑	坏笑 😏 (^～^)
坏蛋	坏蛋 🦹‍♂️ 🦹‍♀️
坐车	坐车 🚙️
坚强	坚强 🥲
坚持	坚持 😣
坟地	坟地 🪦
坟墓	坟墓 🪦
垂直	垂直 ⊥
垃圾	垃圾 🗑
垒球	垒球 🥎
埃及	埃及 🇪🇬
城堡	城堡 🏯 🏰
城市	城市 🏙
城轨	城轨 Ⓜ️
培根	培根 🥓
基佬	基佬 👬🏻️
基友	基友 👬
基因	基因 🧬
基林	基林 🇨🇨
基督	基督 ✝️
堡垒	堡垒 🏰️
堵耳	堵耳 🙉
塔可	塔可 🌮️
塞着	塞着 😧️
墓碑	墓碑 🪦
墙砖	墙砖 🧱
增长	增长 📈
增高	增高 🔼️
墨镜	墨镜 😎 🕶
墨鱼	墨鱼 🦑
壁虎	壁虎 🦎
声调	声调 ˉ ˊ ˇ ˋ ˆ ˙ ˜ ˥ ˦ ˧ ˨ ˩ ꜀ ꜁ ꜂ ꜃ ꜄ ꜅ ꜆ ꜇
声音	声音 🔇 🔈 🔉 🔊
复杂	复杂 🤔️
复选	复选 ☑️
夕阳	夕阳 🌇
外公	外公 👴
外卖	外卖 🍱 🥡
外套	外套 🧥
外婆	外婆 👵
外汇	外汇 💱
外蒙	外蒙 🇲🇳
多云	多云 ⛅
多哥	多哥 🇹🇬
夜晚	夜晚 🌃
夜景	夜景 🌃️
夜色	夜色 🌃️
大于	大于 > ⩼
大人	大人 🧑🏻
大便	大便 💩
大写	大写 🔠
大厦	大厦 🏢️
大厨	大厨 👨‍🍳 👩‍🍳
大叔	大叔 🧔
大哭	大哭 😭
大喊	大喊 🗣️
大声	大声 🔊️
大夫	大夫 👨‍⚕️ 👩‍⚕️
大巴	大巴 🚌 🚍
大恩	大恩 🙏🏻️
大树	大树 🌳
大桥	大桥 🌉
大楼	大楼 🏙️ 🏢️
大正	大正 ㍽
大浪	大浪 🌊
大海	大海 🌊️
大漠	大漠 🏜️
大状	大状 🧑🏻‍⚖️
大王	大王 🃏
大笑	大笑 🤣 😂
大米	大米 🍚
大脑	大脑 🧠
大腿	大腿 🦵
大英	大英 🇬🇧
大蒜	大蒜 🧄
大虾	大虾 🦐
大衣	大衣 🧥
大象	大象 🐘
大陆	大陆 🇨🇳
大雨	大雨 ⛈️
大雪	大雪 ☃️
大饼	大饼 🫓
大马	大马 🇲🇾
大鹅	大鹅 🪿
天使	天使 👼🏻️ 😇
天呐	天呐 😱️ 🤯
天啊	天啊 😱️ 🤯 [天啊]
天平	天平 ⚖️
天房	天房 🕋️
天才	天才 😇️
天晴	天晴 ☀️
天气	天气 ☁️
天线	天线 📡
天阴	天阴 🌥️
天鹅	天鹅 🦢
太子	太子 🤴🏻
太差	太差 👎
太极	太极 ☯️
太棒	太棒 👍
太热	太热 🫠
太阳	太阳 ☀️ 🌞
太阴	太阴 🌙️ 🌝️
太难	太难 😵‍💫 😵️
夫妇	夫妇 👫🏻️
夫妻	夫妻 👫🏻️
失恋	失恋 💔
失望	失望 🙍
失聪	失聪 🧏‍♂️ 🧏‍♀️
失落	失落 (。_。)
头像	头像 👤
头名	头名 🥇
头大	头大 🤦🏻
头巾	头巾 👳‍♂️ 👳‍♀️ 🧕
头晕	头晕 😵 😵‍💫
头疼	头疼 🤦🏻
头盔	头盔 🪖
头秃	头秃 👨‍🦲 👩‍🦲 🦲
头纱	头纱 👰‍♀️
头脑	头脑 🧠
头骨	头骨 💀 ☠️
夹克	夹克 🧥
夹击	夹击 (o￣3)==@))゜ロ゜((@==(′ε′)o
夹子	夹子 🗜
夹钳	夹钳 🗜
奇怪	奇怪 🤔
奋斗	奋斗 💪
奔跑	奔跑 🏃🏻
奔马	奔马 🐎️
奖杯	奖杯 🏆
奖牌	奖牌 🏅
奖章	奖章 🏅️
奖金	奖金 💰
奖项	奖项 🏅️ 🎖 🏆
套娃	套娃 🪆
套餐	套餐 🍱️
奥兰	奥兰 🇦🇽
奥姆	奥姆 🕉
女人	女人 👩
女仔	女仔 🧍‍♀️
女儿	女儿 👧
女包	女包 👜
女厕	女厕 🚺
女同	女同 👩‍❤️‍👩
女士	女士 🚺
女子	女子 👩🏻️
女孩	女孩 👧
女工	女工 👩🏻‍🏭
女巫	女巫 🧙‍♀️
女帽	女帽 👒
女性	女性 ♀
女星	女星 👩🏻‍🎤
女王	女王 👸
女皇	女皇 👸
女童	女童 👧🏻️
女装	女装 👚
女靴	女靴 👢
女鞋	女鞋 👠
奶嘴	奶嘴 🍼️
奶奶	奶奶 👵
奶妈	奶妈 👩‍🍼
奶爸	奶爸 👨‍🍼
奶牛	奶牛 🐄
奶瓶	奶瓶 🍼
奶茶	奶茶 🧋
奶酪	奶酪 🧀
奶黄	奶黄 🍮️
奸笑	奸笑 😈️ [奸笑]
她们	她们 👥️
好㖿	好㖿 😁️
好假	好假 😓️
好冷	好冷 🥶
好劲	好劲 🤩
好叻	好叻 🤩
好吃	好吃 😋
好吧	好吧 😉️ 😪️
好味	好味 😋️
好哒	好哒 👌
好啊	好啊 😁️
好嘛	好嘛 🥺
好嘢	好嘢 👍🏻️
好囧	好囧 😅️ 😰️
好奇	好奇 😯
好强	好强 👍
好棒	好棒 👍
好热	好热 🥵
好玩	好玩 😆️
好的	好的 👌 🙆‍♂️ 🙆‍♀️
好窘	好窘 😅️
好笑	好笑 🤭
好耶	好耶 😆
好萌	好萌 😊️
好评	好评 💯️
好运	好运 🤞 🙏
好难	好难 😵‍💫 😵️
如厕	如厕 🚾️
妃嫔	妃嫔 👸🏻️
妃子	妃子 👸🏻️
妈咪	妈咪 👩🏻️
妈妈	妈妈 👩
妈屄	妈屄 🤬
妈的	妈的 🤬
妊娠	妊娠 🫄🏻
妖怪	妖怪 👺
妖物	妖物 👺️
妖精	妖精 🧚
妹妹	妹妹 🧍‍♀️
妻子	妻子 👰🏻‍♀️
姊妹	姊妹 👭🏻️
姊弟	姊弟 👫🏻️
姐妹	姐妹 👭🏻️
姐姐	姐姐 🧍‍♀️
姐弟	姐弟 👫🏻️
委屈	委屈 🙎🏻 🥹 ╥﹏╥...
姥姥	姥姥 👵
姥爷	姥爷 👴
娃娃	娃娃 👶🏻️ 🎎 🪆
娱乐	娱乐 🎢
婚礼	婚礼 💒
婚纱	婚纱 👰‍♀️
婴儿	婴儿 👶 🚼
婴孩	婴孩 👶🏻️
媚眼	媚眼 😉
嫔妃	嫔妃 👸🏻️
嫩苗	嫩苗 🌱
孔雀	孔雀 🦚
孕妇	孕妇 🤰
孕肚	孕肚 🤰
字母	字母 🔤️
字符	字符 🔣
字节	字节 ㎅ ㎆ ㎇
存在	存在 ∃ ∄
孙女	孙女 👧🏻️
孙子	孙子 👦🏻️
季军	季军 🥉
学位	学位 🎓
学士	学士 🎓️ 🧑🏻‍🎓
学姐	学姐 👩🏻‍🎓
学校	学校 🏫
学生	学生 👨‍🎓 👩‍🎓
学长	学长 👨🏻‍🎓
孩子	孩子 🧒
孲𤘅	孲𤘅 👶🏻️
孵化	孵化 🐣️
宅女	宅女 👩🏻‍💻
宅男	宅男 👨🏻‍💻 🤓
守卫	守卫 💂🏻
守密	守密 🤐
安培	安培 ㎀ ㎁ ㎂ ㎃ ㎄
安巴	安巴 🇦🇬
安慰	安慰 🤗️ 😌 (´･･)ﾉ(._.`)
安检	安检 🛂
安逸	安逸 😌
安静	安静 🤫
完了	完了 😔️
定义	定义 ≔ ≝ ≕
定食	定食 🍱️
宝宝	宝宝 👶 🚼
宝石	宝石 💎
宝贝	宝贝 👶🏻️
客气	客气 😎️
客船	客船 🛳
客轮	客轮 🛳
宣誓	宣誓 ✊🏻️
宫灯	宫灯 🏮️
害怕	害怕 😨
害羞	害羞 😳
家庭	家庭 👪
家禽	家禽 🐔
家蝇	家蝇 🪰
容量	容量 ㎕ ㎖ ㎗ ㎘
宽度	宽度 ↔️
宾馆	宾馆 🏨
密码	密码 🔏️
密钥	密钥 🔐
寒冷	寒冷 🥶
寮国	寮国 🇱🇦
对上	对上 🆚️
对决	对决 🆚
对勾	对勾 ✔️ ✅ ☑ ✓ ⭕ √
对号	对号 ✅ ✔
对战	对战 🆚
对抗	对抗 🆚
对数	对数 ㏑ ㏒
对比	对比 🆚️
对白	对白 💬️
对眼	对眼 (￫ܫ￩)
对称	对称 ⌯
对虾	对虾 🦐
对话	对话 💬️ 🗣
对钩	对钩 ✅ ✔
寺庙	寺庙 🛐️ 🛕
寺院	寺院 🛐️
导弹	导弹 🚀️
寿司	寿司 🍣
封印	封印 〆
封口	封口 🤐
封路	封路 ⛔️
封闭	封闭 〆
射箭	射箭 🏹️
尊敬	尊敬 🫡
尊重	尊重 🫡
小丑	小丑 🤡
小于	小于 < ⩻
小写	小写 🔡
小刀	小刀 🔪
小包	小包 👝️
小区	小区 🏘️
小号	小号 🎺
小声	小声 🤫
小学	小学 🏫️
小孩	小孩 🧒
小屋	小屋 🛖
小岛	小岛 🏝️
小巴	小巴 🚐
小强	小强 🪳
小心	小心 ⚠️
小憩	小憩 😑️
小样	小样 😏️ 😠️ 😾️
小气	小气 🙁️
小熊	小熊 🐻
小狗	小狗 🐶 🐕
小猪	小猪 🐷
小猫	小猫 🐱 🐈
小王	小王 🃏
小票	小票 🧾
小童	小童 🧒🏻
小羊	小羊 🐑
小蛇	小蛇 🐍
小说	小说 📕️
小贩	小贩 👲🏻️
小费	小费 💁🏻‍♂️ 🈂
小马	小马 🐎
小驴	小驴 🫏
小鱼	小鱼 🐟
小鸟	小鸟 🐦
小鸡	小鸡 🐣 🐤 🐥
小鼠	小鼠 🐁️
少云	少云 🌤
少许	少许 🤏
少量	少量 🤏
尖叫	尖叫 🙀
尴尬	尴尬 😅 😰 😓
尺子	尺子 📏
尼姑	尼姑 👩‍🦲
尼日	尼日 🇳🇪
屋企	屋企 🏠️
屋子	屋子 🏡
属于	属于 ∈ ∋
属兔	属兔 🐰️
属牛	属牛 🐮️
属狗	属狗 🐶️
属猪	属猪 🐷️
属猫	属猫 🐱️
属猴	属猴 🐵️
属虎	属虎 🐯️
属蛇	属蛇 🐍️
属马	属马 🐴️
属鸡	属鸡 🐔️
属鼠	属鼠 🐭️
属龙	属龙 🐲️
山岭	山岭 ⛰️
山峰	山峰 ⛰️
山水	山水 🏞️
山羊	山羊 🐐
山脉	山脉 ⛰️
山轨	山轨 🚞️
岛国	岛国 🗾️
岛屿	岛屿 🗾️ 🏝
岩石	岩石 🪨
崇拜	崇拜 🤩
崩溃	崩溃 o(≧口≦)o
工人	工人 👷‍♂️ 👷‍♀️
工具	工具 🛠
工厂	工厂 🏭
工地	工地 🏗️
工资	工资 💰
左上	左上 ↖️ ↖
左下	左下 ↙️ ↙
左前	左前 ↖️
左右	左右 ↔️ ↔︎
左后	左后 ↙️
左手	左手 🫲 🫷
左拳	左拳 🤜
左推	左推 🫷
左边	左边 👈
左面	左面 👈
巨怪	巨怪 🧌
巨魔	巨魔 🧌
巨龙	巨龙 🐉
巫师	巫师 🧙‍
差人	差人 👮🏻
差佬	差佬 👮🏻‍♂️
差劲	差劲 👎
巴士	巴士 🚌 🚍
巴林	巴林 🇧🇭
巴西	巴西 🇧🇷
布丁	布丁 🍮
布告	布告 🪧
帆船	帆船 ⛵
希腊	希腊 🇬🇷
帐本	帐本 📒️
帐篷	帐篷 ⛺
帐簿	帐簿 📒️
帕劳	帕劳 🇵🇼
帛琉	帛琉 🇵🇼
帽子	帽子 🎩
干你	干你 👊
干杯	干杯 🍻 🥂
平成	平成 ㍻
平方	平方 ²
平行	平行 ∥
平静	平静 😐
并肩	并肩 🧑🏻‍🤝‍🧑🏻
并集	并集 ∪
幸福	幸福 🥰
幸运	幸运 🍀️
幼儿	幼儿 👶🏻️
幼稚	幼稚 😒️
幼童	幼童 👶🏻️
幼苗	幼苗 🌱
幼虫	幼虫 🐛️
幽浮	幽浮 🛸
幽灵	幽灵 👻
幽魂	幽魂 👻️
广播	广播 📢️ 📻️
庆典	庆典 🎈
庆祝	庆祝 🥳 🎉
底片	底片 🎞️
庙宇	庙宇 🛕
废了	废了 😖️
废话	废话 🙄️
度假	度假 🏖
座位	座位 💺
座机	座机 ☎️
座椅	座椅 💺️
座钟	座钟 🕰
建筑	建筑 🏛 🏗 👷
开启	开启 🔛
开始	开始 ▶️
开心	开心 😄
开战	开战 ⚔️
开曼	开曼 🇰🇾
开花	开花 🌼
开趴	开趴 🥳
开车	开车 🚘️
开锁	开锁 🔓
开饭	开饭 😋️
异形	异形 👽️
弓箭	弓箭 🏹
弟弟	弟弟 🧍‍♂️
张开	张开 👐🏻️
弦月	弦月 🌙
弧度	弧度 ㎭ ㎮ ㎯
弯月	弯月 🌙
弯钩	弯钩 🪝
弱小	弱小 🫥
弹出	弹出 ⏏️
弹琴	弹琴 🎹️
强壮	强壮 💪
当心	当心 ⚠️
当然	当然 🙄️
录像	录像 ⏺️
录音	录音 ⏺️
彗星	彗星 ☄️
彩带	彩带 🎀️
彩旗	彩旗 🚩️
彩椒	彩椒 🫑
彩球	彩球 🎊️
彩礼	彩礼 💝️
彩虹	彩虹 🌈
彩蛋	彩蛋 🎉️
影片	影片 🎞️
影相	影相 📸️
影院	影院 🎬️
往上	往上 👆
往下	往下 👇
往右	往右 👉
往左	往左 👈
很冷	很冷 🥶
很好	很好 👍
很棒	很棒 👍
很热	很热 🥵
很酷	很酷 🆒
律师	律师 🧑🏻‍⚖️
徒步	徒步 🚶‍♂️ 🚶‍♀️
得意	得意 😏
循环	循环 ♻️
微怒	微怒 😠
微笑	微笑 😊
微米	微米 ㎛
微醺	微醺 🥴
微风	微风 🍃️
德国	德国 🇩🇪
心伤	心伤 ❤️‍🩹
心动	心动 💓
心形	心形 ♥️
心火	心火 ❤️‍🔥
心烦	心烦 😫️ 😠
心田	心田 💟️
心疼	心疼 ❤️‍🩹
心痛	心痛 ❤️‍🩹
心碎	心碎 💔
心脏	心脏 🫀
心跳	心跳 💓
心间	心间 💟️
忍术	忍术 🥷
忍者	忍者 🥷
忍耐	忍耐 😣
忧伤	忧伤 😔
忧虑	忧虑 😔
快上	快上 ⏫
快下	快下 ⏬
快乐	快乐 🎉
快件	快件 📦️
快艇	快艇 🚤
快进	快进 ⏩
快退	快退 ⏪
快递	快递 📦
快餐	快餐 🍱
念珠	念珠 📿
怀了	怀了 🤰
怀孕	怀孕 🤰
怀疑	怀疑 🤔 🤨 🧐
思考	思考 🤔
怨念	怨念 o(一︿一+)o
怪兽	怪兽 👾
怪物	怪物 👹
恋爱	恋爱 👩‍❤️‍👨
恐怖	恐怖 😱
恐惧	恐惧 😱
恐龙	恐龙 🦕 🦖
恤衫	恤衫 👕
恭喜	恭喜 🎉
恳求	恳求 🥺 (っ´Ι`)っ
恳请	恳请 🥺
恶心	恶心 🤢
恶魔	恶魔 😈 👿
悔恨	悔恨 😣
悬浮	悬浮 🕴🏻️
悲剧	悲剧 (＞﹏＜)
情书	情书 💌
情侣	情侣 👫
情调	情调 🫦
惊叹	惊叹 ❗
惊喜	惊喜 😃️ 🤩 ╰(*°▽°*)╯
惊悚	惊悚 😱️ 🙀️
惊艳	惊艳 🤩
惊讶	惊讶 😺
惊问	惊问 ⁉️
想吃	想吃 😍️ 😻️
想吐	想吐 🤢
想想	想想 🤔
想法	想法 💭️
想要	想要 😻️
意粉	意粉 🍝
意面	意面 🍝
愚蠢	愚蠢 🤪 (´◑д◐｀)
愚鸠	愚鸠 🦤
感人	感人 🥹
感冒	感冒 😷 🤧
感动	感动 🥹
感恩	感恩 🥹
感情	感情 💑🏻️
感谢	感谢 🙏
愣住	愣住 😳
愤怒	愤怒 😡 😠 💢
慢走	慢走 🚶🏻
憋屈	憋屈 🙎🏻
憨憨	憨憨 😄
懒猪	懒猪 🐷
懒腰	懒腰 ٩(๑´0`๑)۶
戆居	戆居 🐷️
戏剧	戏剧 🎭️
戏弄	戏弄 😛 😜 😝
戏曲	戏曲 🎭️
戏法	戏法 🤹🏻
戏院	戏院 🎥️ 🎬️
成人	成人 🔞
成功	成功 ✌️
我晕	我晕 😵 😵‍💫
我肏	我肏 😧️ 🤬
戒指	戒指 💍
战斗	战斗 ⚔️
房子	房子 🏠
房屋	房屋 🏠
房门	房门 🚪
所以	所以 ∴
扇子	扇子 🪭
手串	手串 📿
手写	手写 ✍️
手套	手套 🧤
手心	手心 🖐🏻
手指	手指 🤌
手掌	手掌 ✋
手机	手机 📱
手杖	手杖 🦯
手枪	手枪 🔫
手柄	手柄 🎮
手球	手球 🤾‍♂️ 🤾‍♀️
手电	手电 🔦
手纸	手纸 🧻
手背	手背 🤚
手臂	手臂 💪🏻 🦾
手表	手表 ⌚
手锯	手锯 🪚
手雷	手雷 💣️
才怪	才怪 😒️ 🙄️
扑克	扑克 ♠️ ♥️ ♦️ ♣️ 🃏
打伞	打伞 ☂️ ☔
打你	打你 👊
打击	打击 👊
打勾	打勾 ✅️ ☑
打包	打包 📦
打印	打印 🖨 ⎙
打叉	打叉 ❎️
打嗝	打嗝 ε-(´∀｀;)
打圈	打圈 ➰️
打坐	打坐 🧘‍♂️ 🧘‍♀️
打折	打折 🈹
打旋	打旋 ➰️
打机	打机 🎮️
打板	打板 🎬
打滚	打滚 🤣
打牌	打牌 🃏️
打球	打球 ⛹🏻️
打的	打的 🚖️
打结	打结 🪢
打脸	打脸 [打脸]
打车	打车 🚖️
打针	打针 💉
打钩	打钩 ☑️
打雷	打雷 🌩
打靶	打靶 🎯️
打鼓	打鼓 🥁
打鼔	打鼔 🥁
托运	托运 🛄️
扣针	扣针 🧷
执照	执照 🪪
扫帚	扫帚 🧹
扫把	扫把 🧹
扯谎	扯谎 🤥
扳手	扳手 🔧
扶桑	扶桑 🌼
扶额	扶额 🤦‍♂️ 🤦‍♀️
批萨	批萨 🍕
找换	找换 💱️
找死	找死 😠️ 😾️
技工	技工 👨‍🔧 👩‍🔧
技师	技师 🧑🏻‍🔧
把戏	把戏 🤹🏻
抓狂	抓狂 😫
投票	投票 🗳
投降	投降 🏳
折扇	折扇 🪭
抛接	抛接 🤹‍♂️ 🤹‍♀️
抠鼻	抠鼻 [抠鼻]
护士	护士 🧑🏻‍⚕️
报纸	报纸 📰
报表	报表 📊️
报警	报警 🚔️
披萨	披萨 🍕️
抬起	抬起 🫴
抱抱	抱抱 🤗 🫂
抽烟	抽烟 🚬
担心	担心 😟
担忧	担忧 😟
拇指	拇指 👍 👎
拉屎	拉屎 💩
拉弓	拉弓 🏹️
拉拉	拉拉 👩‍❤️‍👩
拉炮	拉炮 🎉️
拉面	拉面 🍜
拍戏	拍戏 🎬️
拍手	拍手 👏
拍掌	拍掌 👏
拍照	拍照 📸
拍片	拍片 🩻
拐杖	拐杖 🩼
拒绝	拒绝 🙅‍♂️ 🙅‍♀️
拖车	拖车 🚛
拖鞋	拖鞋 🩴
招呼	招呼 🙋🏻 (｡･∀･)ﾉﾞヾ(･ω･。)
招手	招手 🙋🏻
拜托	拜托 🙏
拜拜	拜拜 👋
拜金	拜金 🤑
拥抱	拥抱 🤗 🫂
拳击	拳击 🥊
拳头	拳头 👊
拳套	拳套 🥊
拼图	拼图 🧩
拼块	拼块 🧩
挂历	挂历 🗓️
挂钩	挂钩 🪝
挂镜	挂镜 🪞
指人	指人 🫵
指你	指你 🫵
指我	指我 🫵
指数	指数 💹️
指环	指环 💍️
指着	指着 🫵
按摩	按摩 💆‍♂️ 💆‍♀️
按钉	按钉 📌 📍 📎
按钮	按钮 ☑️ 🔘
挎包	挎包 👜
挑眉	挑眉 🤨
挥手	挥手 👋
挥洒	挥洒 💦️
挪威	挪威 🇳🇴
振奋	振奋 (o>ε(o>ｕ(≧∩≦)
捂嘴	捂嘴 🤭 🙊
捂耳	捂耳 🙉
捂脸	捂脸 🤦‍♂️ 🤦‍♀️
捏合	捏合 🤌
捏着	捏着 🤏🏻
换汇	换汇 💱
换脸	换脸 🎭️
捣蛋	捣蛋 😜
捧着	捧着 🤲
捧花	捧花 💐
捷克	捷克 🇨🇿
捷运	捷运 🚇️
掀桌	掀桌 （╯°口°）╯︵┴─┴ (ノ=Д=)ノ┻━┻ (╯‵□′)╯︵┻━┻ o(*≧▽≦)ツ┏━┓ ┻━┻︵╰(‵□′)╯︵┻━┻
掌印	掌印 🐾
掌心	掌心 🤲🏻
排球	排球 🏐
排骨	排骨 🍖
探究	探究 🧐
探长	探长 🕵🏻
接吻	接吻 😘️
接地	接地 ⏚
接纳	接纳 👐🏻
推出	推出 ⏏️
推手	推手 🫷 🫸
掸指	掸指 🤞🏻
揍你	揍你 👊
提子	提子 🍇
提款	提款 🏧️
提琴	提琴 🎻
提醒	提醒 🔔️
插头	插头 🔌
插销	插销 🔌
握手	握手 🤝
握拳	握拳 ✊
握笔	握笔 ✍🏻
揹包	揹包 🎒
搅基	搅基 👬🏻
搋子	搋子 🪠
搜寻	搜寻 🔍️
搜索	搜索 🔍️
搞定	搞定 🤝
搭的	搭的 🚖️
摁钉	摁钉 📌 📍 📎
摄像	摄像 🎦️
摆手	摆手 👋
摇头	摇头 🫨
摇摇	摇摇 🪀
摇杆	摇杆 🕹
摇滚	摇滚 🤘
摊手	摊手 🤷🏻 ┑(￣Д￣)┍ ㄟ(▔,▔)ㄏ
摔跤	摔跤 🤼‍♂️ 🤼‍♀️
摩尔	摩尔 ㏖
摩托	摩托 🏍
撅嘴	撅嘴 😗️
撇嘴	撇嘴 🫤
撑伞	撑伞 ☂️ ☔
撒花	撒花 🎉️
撒谎	撒谎 🤥
撞击	撞击 💥️
撤回	撤回 ↩️
撤销	撤销 ↩️
播放	播放 ▶️
擕手	擕手 🧑🏻‍🤝‍🧑🏻
攀山	攀山 🧗‍♂️ 🧗‍♀️
攀岩	攀岩 🧗🏻
攀登	攀登 🧗🏻
收件	收件 📥
收信	收信 📥
收声	收声 🫢
收据	收据 🧾
收费	收费 🈶
改锥	改锥 🪛
放射	放射 ☢️
放屁	放屁 ○|￣|_=3
放手	放手 🫳
放松	放松 😌
救命	救命 🆘
救我	救我 🆘
救火	救火 🚒️
救生	救生 🛟
教书	教书 🧑🏻‍🏫
教堂	教堂 💒 ⛪
教师	教师 👨‍🏫 👩‍🏫
散度	散度 ∇·
敬礼	敬礼 🫡
数字	数字 🔢
敲鼓	敲鼓 🥁
文书	文书 📄
文件	文件 📄
文档	文档 📄️
文莱	文莱 🇧🇳
斐济	斐济 🇫🇯
斑马	斑马 🦓
斜眼	斜眼 😏️
斜面	斜面 ⌳
斧头	斧头 🪓
斧子	斧子 🪓
新人	新人 🤵🏻 👰🏻
新妇	新妇 👰🏻‍♀️
新娘	新娘 👰‍♀️
新年	新年 🎆️
新建	新建 🆕
新手	新手 🔰️
新月	新月 🌑 🌚
新款	新款 🆕️
新的	新的 🆕
新郎	新郎 🤵‍♂️
新闻	新闻 📰
方向	方向 🧭
方块	方块 ⬛ ⬜
方形	方形 ⬛ ⬜
方板	方板 ♦️
方框	方框 ☐
方片	方片 ♦️
施工	施工 🏗 🚧
旄牛	旄牛 🦬
旅店	旅店 🏨
旅舍	旅舍 🛌🏻️
旅馆	旅馆 🏨
旋度	旋度 ∇×
旋律	旋律 🎶️
旋钮	旋钮 🎛
旋风	旋风 🌀
旗子	旗子 🚩
旗帜	旗帜 🚩
无助	无助 🙍🏻 😣
无奈	无奈 😮‍💨
无望	无望 🙍🏻
无穷	无穷 ♾️ ∞ +∞ -∞
无线	无线 🛜
无聊	无聊 😞️ 😴️
无语	无语 😅 😰 😓
无辜	无辜 😐️ （o´・ェ・｀o）
无限	无限 ♾️ ∞
日元	日元 ￥ 💴
日光	日光 🌞️
日円	日円 💴️
日出	日出 🌄 🌅
日历	日历 📅
日圆	日圆 💴️
日币	日币 ￥
日暮	日暮 🌇️
日本	日本 🇯🇵
日火	日火 👿️
日落	日落 🌇
旧屋	旧屋 🏚️
早晨	早晨 🌄️
旭日	旭日 🌄 🌅
旱冰	旱冰 🛼
时计	时计 ⏲️
旺柴	旺柴 🐶
旺财	旺财 🐶
昆虫	昆虫 🪲
明亮	明亮 🌞️
明星	明星 🌟️ 🧑🏻‍🎤
明治	明治 ㍾
明白	明白 (oﾟvﾟ)ノ
星光	星光 🌟️
星号	星号 *️⃣
星国	星国 🇸🇬
星型	星型 ✴️
星星	星星 ⭐ 🌟 ✨
星月	星月 ☪️
星球	星球 🪐
星空	星空 🌌
星系	星系 🌌️
星钻	星钻 💍
春心	春心 💗️
昭和	昭和 ㍼
是吗	是吗 😳️
晃脑	晃脑 🫨
晕了	晕了 😵 😵‍💫
晕头	晕头 😵 😵‍💫
晕车	晕车 🥴
晚上	晚上 🌃
晚安	晚安 😴
晴天	晴天 ☀️
晴朗	晴朗 ☀️
晴空	晴空 ☀️
智利	智利 🇨🇱
智慧	智慧 😇️
智障	智障 (◐‿◑)
暂停	暂停 ⏸️
暮光	暮光 🌆️
暮色	暮色 🌆
暴涨	暴涨 📈
暴跌	暴跌 📉
暴风	暴风 🌀
暴龙	暴龙 🦖
暹罗	暹罗 🇹🇭
曱甴	曱甴 🪳
曲奇	曲奇 🍪
曲谱	曲谱 🎼️
曼岛	曼岛 🇮🇲
最右	最右 →_→
最左	最左 ←_←
月亮	月亮 🌙
月光	月光 🌝️
月团	月团 🥮
月圆	月圆 🌕️
月夜	月夜 🌙️
月牙	月牙 🌙
月球	月球 🌕
月神	月神 🌝️
月老	月老 💘️
月色	月色 🌃️ 🌙️
月芽	月芽 🌛️ 🌜️
月蚀	月蚀 🌑️
月食	月食 🌒 🌘
月饼	月饼 🥮
有云	有云 ☁️
有料	有料 🈶
有毒	有毒 ☠️ 🤢
有电	有电 ⚡️
有病	有病 🤒️
有钱	有钱 💰️
有雨	有雨 🌧️
有雾	有雾 🌁️
朋克	朋克 👨‍🎤 👩‍🎤
服了	服了 🤦‍♂️ 🤦‍♀️
朔月	朔月 🌑 🌚
朝上	朝上 🫴
朝下	朝下 🫳
朝右	朝右 🫱
朝左	朝左 🫲
朝阳	朝阳 🌄️
朝鲜	朝鲜 🇰🇵
期待	期待 (☆▽☆)
木头	木头 🪵
木星	木星 🪐
木材	木材 🪵
木柴	木柴 🪵
木槿	木槿 🌺
机智	机智 [机智]
机灵	机灵 😉️
机长	机长 🧑🏻‍✈️
杂技	杂技 🤹🏻 🎪️
杂种	杂种 🤬
杂耍	杂耍 🤹‍♂️ 🤹‍♀️
杠铃	杠铃 🏋🏻
条城	条城 🏯️
条子	条子 👮🏻
来信	来信 📨
来电	来电 📲
杧果	杧果 🥭
杯子	杯子 🥛
松树	松树 🌲
松饼	松饼 🍪️ 🥞
松鼠	松鼠 🐿
板札	板札 🙌🏻️
板栗	板栗 🌰️
板球	板球 🏏
板砖	板砖 🧱
板车	板车 🛴
板鞋	板鞋 👟
果冻	果冻 🍮
果岭	果岭 ⛳️
果汁	果汁 🧃
果酒	果酒 🍸️
果饮	果饮 🍹
枝条	枝条 🌿️
枫叶	枫叶 🍁
枯叶	枯叶 🍂️
枯萎	枯萎 🥀
柏树	柏树 🌳️
某人	某人 👤️
柑橘	柑橘 🍊
柔道	柔道 🤼🏻 🥋
柠檬	柠檬 🍋
查德	查德 🇹🇩
查找	查找 🔍️ 🔎
柿子	柿子 🍅
标准	标准 ⊖ ⦵
标签	标签 🏷
标语	标语 🪧
树叶	树叶 🍃
树懒	树懒 🦥
树木	树木 🌳
树枝	树枝 🌿️
树獭	树獭 🦥
树苗	树苗 🌱️
栗子	栗子 🌰
校巴	校巴 🚍️
校车	校车 🚍️
核子	核子 ⚛️
核弹	核弹 ☢️
核电	核电 ⚛️
核突	核突 🤢 🤮
核能	核能 ⚛️
根号	根号 √ ∛ ∜
根西	根西 🇬🇬
格尺	格尺 📏
格斗	格斗 🤼‍♂️ 🤼‍♀️
桃子	桃子 🍑
桃花	桃花 🌸️
框三	🈪
桌游	桌游 🎴️
桌球	桌球 🎱️
桑拿	桑拿 🧖‍♂️ 🧖‍♀️
档案	档案 🗃️
梁龙	梁龙 🦕
梅花	梅花 ♣️
梨子	梨子 🍐
梯子	梯子 🪜
梯度	梯度 ∇
梯形	梯形 ⏢
梳子	梳子 🪮
梵铃	梵铃 🎻️
检察	检察 🧐
棒呆	棒呆 🤩
棒啊	棒啊 👍
棒棒	棒棒 👍
棒球	棒球 ⚾
棕圆	棕圆 🟤
棕心	棕心 🤎
棕榈	棕榈 🌴
棕熊	棕熊 🐻️
棕色	棕色 🟤 🟫
森林	森林 🌲️
棺材	棺材 ⚰️
椅子	椅子 🪑
椪柑	椪柑 🍊️
椰子	椰子 🥥
椰汁	椰汁 🥥
椰肉	椰肉 🥥
椰蓉	椰蓉 🥥
榔头	榔头 🔨️
槽耐	槽耐 🤮
模糊	模糊 🫨
樱桃	樱桃 🍒
樱花	樱花 🌸
橄榄	橄榄 🫒
橘子	橘子 🍊
橘心	橘心 🧡
橘猫	橘猫 🐈
橘色	橘色 🟠 🟧
橘黄	橘黄 🟧
橙圆	橙圆 🟠
橙子	橙子 🍊️
橙心	橙心 🧡
橙色	橙色 🟠 🟧
欢呼	欢呼 🙋🏻 🥳
欢庆	欢庆 🎊️ 🙌🏻️ 🍾
欢迎	欢迎 🙋🏻 (＾∀＾)／欢迎＼(＾∀＾)
欣慰	欣慰 🥲
欧元	欧元 € 💶
欧圆	欧圆 💶️
欧姆	欧姆 ㏀ ㏁
欧洲	欧洲 🌍
欧盟	欧盟 🇪🇺
歌厅	歌厅 🪩
歌手	歌手 👨‍🎤 👩‍🎤
歌星	歌星 🧑🏻‍🎤
正比	正比 ∝
正确	正确 ✅ ✔
正装	正装 👔️
正负	正负 ± ∓
歪嘴	歪嘴 🤪
死亡	死亡 💀 ☠️
死猪	死猪 🐖️
残月	残月 🌒 🌘
残杖	残杖 🩼
残疾	残疾 🧑🏻‍🦼 🧑🏻‍🦽
残阳	残阳 🌇️
段落	段落 ¶ ⁋
母乳	母乳 🤱
母亲	母亲 👩
母女	母女 👩‍👧
母子	母子 👩‍👦
母鸡	母鸡 🐓
比心	比心 🫰 🫶
比萨	比萨 🍕
比赛	比赛 🆚
毕业	毕业 👨‍🎓 👩‍🎓
毛线	毛线 🧶
毛虫	毛虫 🐛
毛象	毛象 🦣
毫克	毫克 ㎎
毫米	毫米 ㎜
民国	民国 🇹🇼
民工	民工 👷🏻
民警	民警 👮🏻
气旋	气旋 🌀
气泡	气泡 🫧
气炸	气炸 🤯
气球	气球 🎈
气馁	气馁 🙁️
氢弹	氢弹 ☢️
水战	水战 🔫️
水枪	水枪 🔫
水桶	水桶 🪣
水母	水母 🪼
水滴	水滴 💦 💧
水牛	水牛 🐃
水獭	水獭 🦦
水珠	水珠 💦 💧
水球	水球 🤽‍♂️ 🤽‍♀️
水稻	水稻 🌾
水笔	水笔 🖋️
水饺	水饺 🥟
求和	求和 ∑
求救	求救 🆘
汇兑	汇兑 💱️
汇率	汇率 💱
汉堡	汉堡 🍔
汉服	汉服 👘️
汗水	汗水 💦
汗滴	汗滴 💧
江豚	江豚 🐡️
污染	污染 🏭️ 😷️
汤加	汤加 🇹🇴
汤勺	汤勺 🥄
汤匙	汤匙 🥄
汤圆	汤圆 ⚪
汤面	汤面 🍜️
汶莱	汶莱 🇧🇳
汽水	汽水 🥤
汽艇	汽艇 🛥️
汽车	汽车 🚗 🚘
沉默	沉默 😶
沐浴	沐浴 🛁️
沙冰	沙冰 🍧️
沙发	沙发 🛋
沙拉	沙拉 🥗
沙滩	沙滩 🏖️
沙漏	沙漏 ⌛ ⏳
沙漠	沙漠 🏜
沙特	沙特 🇸🇦
沙球	沙球 🪇
沙锤	沙锤 🪇
没了	没了 😖️
没戏	没戏 😔️
没有	没有 🈚️
没电	没电 🪫
没脸	没脸 🤦‍
没说	没说 🙊️
没钱	没钱 💸️
没门	没门 🙅🏻
沮丧	沮丧 🙍🏻
河狸	河狸 🦫
河豚	河豚 🐡
河马	河马 🦛
油桶	油桶 🛢
油灯	油灯 🪔
油站	油站 ⛽️
油筒	油筒 🛢️
泊位	泊位 🅿️
泊车	泊车 🅿️
法国	法国 🇫🇷
法官	法官 👨‍⚖️ 👩‍⚖️
法师	法师 🧙‍♂️ 🧙‍♀️
法拉	法拉 ㎊ ㎋ ㎌
法杖	法杖 🪄
法棍	法棍 🥖
法轮	法轮 ☸️
法郎	法郎 ₣
泛舟	泛舟 🚣‍♂️ 🚣‍♀️
泡泡	泡泡 🫧
泡澡	泡澡 🛀
波兰	波兰 🇵🇱
波奈	波奈 🇧🇶
波斯	波斯 🇮🇷
波浪	波浪 🌊
波罗	波罗 🍍️
波黑	波黑 🇧🇦
注册	注册 ®
注意	注意 ⚠️
注目	注目 👁️
注视	注视 👀
泰国	泰国 🇹🇭
泰迪	泰迪 🧸
泳客	泳客 🏊‍♂️ 🏊‍♀️
泳衣	泳衣 🩱
泳装	泳装 🩱 👙
泳裤	泳裤 🩲
泳镜	泳镜 🥽
泽西	泽西 🇯🇪
洋服	洋服 🤵🏻
洋竽	洋竽 🥔
洋芋	洋芋 🥔
洋葱	洋葱 🧅
洋蒜	洋蒜 🧅
洋酒	洋酒 🥃
洒水	洒水 💦️
洗浴	洗浴 🛀️ 🛁️ 🚿
洗澡	洗澡 🛀
派对	派对 🥳 🎉
流出	流出 🫗
流星	流星 🌠
流汗	流汗 😓
流泪	流泪 😢
流涎	流涎 🤤
流通	流通 💱
浣熊	浣熊 🦝
浪花	浪花 🌊
浮潜	浮潜 🤿
浴缸	浴缸 🛁
浴衣	浴衣 👘
海产	海产 🐟️
海关	海关 🛃
海啸	海啸 🌊️
海地	海地 🇭🇹
海岛	海岛 🏝️
海报	海报 🪧
海棠	海棠 🌺️
海浪	海浪 🌊️
海滩	海滩 🏖️
海狮	海狮 🦭
海狸	海狸 🦫
海獭	海獭 🦦
海盗	海盗 🏴‍☠️
海绵	海绵 🧽
海蜇	海蜇 🪼
海螺	海螺 🐚
海豚	海豚 🐬
海豹	海豹 🦭
海贼	海贼 🏴‍☠️
海边	海边 🏖️ ⛱️ 🐚 🌊 👙
海运	海运 🚢
海鲜	海鲜 🐟️
海龟	海龟 🐢
消失	消失 🫠 🫥
消防	消防 👨‍🚒
淋浴	淋浴 🚿
淡定	淡定 ━━(￣ー￣*|||━━
深夜	深夜 🌃
深思	深思 🤔
深潜	深潜 🤿
混乱	混乱 🙃️
清晨	清晨 🌄️
清洗	清洗 🧴
清理	清理 🆑
清真	清真 🕌
清空	清空 🆑️
清酒	清酒 🍶
清除	清除 🆑
渔竿	渔竿 🎣
渡口	渡口 ⛴️
渡船	渡船 ⛴
渡轮	渡轮 ⛴
温泉	温泉 ♨️
港元	港元 HK$
港币	港币 HK$
渴望	渴望 😻️ ❤️‍🔥
游戏	游戏 🎮️ 👾️
游泳	游泳 🏊‍♂️ 🏊‍♀️
溜冰	溜冰 ⛸
溜石	溜石 🥌
溶剂	溶剂 🧪
溶液	溶液 🧪
溶解	溶解 🫠
滑冰	滑冰 ⛸
滑块	滑块 🎚
滑杆	滑杆 🎚️
滑板	滑板 🛹
滑梯	滑梯 🛝
滑稽	滑稽 😏️
滑雪	滑雪 ⛷️
滑鼠	滑鼠 🖱️
滚粗	滚粗 🤬
满了	满了 🈵
满分	满分 💯
满座	满座 🈵
满意	满意 😌 （´v｀）
满月	满月 🌕 🌝
满足	满足 o(*￣︶￣*)o (๑¯∀¯๑)
滴血	滴血 🩸
漂亮	漂亮 😍️ 😻️
演讲	演讲 🗣️
漠然	漠然 😶️
漩涡	漩涡 🌀
漫步	漫步 🚶🏻
潜水	潜水 🤿
潮女	潮女 👩🏻‍🎤
潮男	潮男 👨🏻‍🎤
澡盆	澡盆 🛁️
澳洲	澳洲 🌏 🇦🇺
澳门	澳门 🇲🇴
激动	激动 ❤️‍🔥
激情	激情 ❤️‍🔥
灌木	灌木 🌳️
火了	火了 🔥
火大	火大 💢
火山	火山 🌋
火星	火星 ✨
火热	火热 ❤️‍🔥
火焰	火焰 🔥
火着	火着 🔥️
火箭	火箭 🚀
火花	火花 ❇️ 💥️
火苗	火苗 🔥️
火警	火警 🚨️ 🧑🏻‍🚒
火车	火车 🚆
火锅	火锅 🥘 🍲
火鸡	火鸡 🦃
灯泡	灯泡 💡
灯神	灯神 🧞‍♂️ 🧞‍♀️
灯笼	灯笼 🏮
灰心	灰心 🩶
灰鼠	灰鼠 🐀️
灵柩	灵柩 ⚰️
灵魂	灵魂 👻️
炎热	炎热 🥵 🫠
炮仗	炮仗 🧨
炸了	炸了 🤯
炸弹	炸弹 💣
炸药	炸药 🧨
炸虾	炸虾 🍤
点心	点心 🥧
点火	点火 🔥️
点烟	点烟 🚬️
点燃	点燃 🔥
点着	点着 🔥️
点赞	点赞 👍
烘焙	烘焙 🥯
烙饼	烙饼 🥞
烛光	烛光 🕯
烛火	烛火 🕯
烟囱	烟囱 🏭️
烟火	烟火 🎆️ 🎇
烟肉	烟肉 🥓
烟花	烟花 🎆 🎇
烤烟	烤烟 🚬
烤饼	烤饼 🥞 🫓
烦死	烦死 😡
烧火	烧火 🔥️
烧瓶	烧瓶 ⚗️
烧着	烧着 🔥️
烫口	烫口 🥵
热心	热心 ❤️‍🔥
热情	热情 ❤️‍🔥 ☺️
热死	热死 🥵
热爱	热爱 😻️
热狗	热狗 🌭
热茶	热茶 🍵️
热饮	热饮 ☕
烹饪	烹饪 🍳
焗饭	焗饭 🥘
焦虑	焦虑 😐
焦躁	焦躁 😩
焰火	焰火 🎆 🎇
煎蛋	煎蛋 🍳
煎饼	煎饼 🥞 🌯
照明	照明 🔦
照相	照相 📸️
熊头	熊头 🐻
熊市	熊市 📉️
熊猫	熊猫 🐼
熊脸	熊脸 🐻
熔化	熔化 🫠
燃烧	燃烧 🔥
爆头	爆头 🤯
爆炸	爆炸 💥
爆竹	爆竹 🧨
爆辣	爆辣 🥵
爪印	爪印 🐾
爬梯	爬梯 🪜
爬泳	爬泳 🏊🏻
爱你	爱你 🤟
爱心	爱心 💖 ♥️
爱情	爱情 💓 💕 👩‍❤️‍👨
爱意	爱意 💟️
爱慕	爱慕 🥰
爱火	爱火 ❤️‍🔥
父亲	父亲 👨
父女	父女 👨‍👧
父子	父子 👨‍👦
爷爷	爷爷 👴
爸爸	爸爸 👨
版权	版权 ©
牌子	牌子 🪧
牙刷	牙刷 🪥
牙牙	牙牙 🦷
牙齿	牙齿 🦷
牛乳	牛乳 🥛
牛仔	牛仔 🤠
牛头	牛头 🐮
牛奶	牛奶 🥛
牛市	牛市 📈️
牛年	牛年 🐮️
牛排	牛排 🥩
牛油	牛油 🧈
牛肉	牛肉 🐂️
牛脸	牛脸 🐮
牛逼	牛逼 👍
牡蛎	牡蛎 🦪
牦牛	牦牛 🦬
物流	物流 🚚
牵手	牵手 🧑‍🤝‍🧑
特棒	特棒 👍
犀牛	犀牛 🦏
状师	状师 🧑🏻‍⚖️
犹太	犹太 🕍
狂笑	狂笑 🤣
狐狸	狐狸 🦊
狗仔	狗仔 🐶
狗头	狗头 🐶
狗子	狗子 🐕
狗年	狗年 🐶️
狗狗	狗狗 🐕
狗绳	狗绳 🐕‍🦺
狗肉	狗肉 🐕️
狗脸	狗脸 🐶
狡黠	狡黠 🌝️
狮头	狮头 🦁
狮子	狮子 🦁
狮脸	狮脸 🦁
狼头	狼头 🐺
狼狗	狼狗 🐺️
狼脸	狼脸 🐺
猎豹	猎豹 🐆
猛犸	猛犸 🦣
猩猩	猩猩 🦍 🦧
猪头	猪头 🐷
猪年	猪年 🐷️
猪排	猪排 🥩
猪肉	猪肉 🐖️
猪脸	猪脸 🐷
猪鼻	猪鼻 🐽
猫咪	猫咪 🐱 🐈
猫头	猫头 🐱
猫年	猫年 🐱️
猫熊	猫熊 🐼
猫肉	猫肉 🐈️
猫脸	猫脸 🐱
猴头	猴头 🐵
猴子	猴子 🐒
猴年	猴年 🐵️
猴脸	猴脸 🐵
玄武	玄武 🐢️
玄鸟	玄鸟 🐦‍⬛
玉米	玉米 🌽
王储	王储 🤴🏻
王冠	王冠 👑
王后	王后 👸🏻️
王女	王女 👸🏻️ 🤴🏻
王妃	王妃 👸🏻️
王子	王子 🤴
王爷	王爷 🤴🏻
王男	王男 👸🏻️
玩火	玩火 🔥️
玩笑	玩笑 😜️
玫瑰	玫瑰 🌹
环保	环保 ♻️
玻璃	玻璃 👨‍❤️‍👨
珊瑚	珊瑚 🪸
班卓	班卓 🪕
球员	球员 ⛹🏻️
球拍	球拍 🏸
球杆	球杆 🏑️ 🏒️
球洞	球洞 🕳️
球网	球网 🥅
球门	球门 🥅
球鞋	球鞋 👟️
理发	理发 💇‍♂️ 💇‍♀️
理头	理头 💇‍♂️ 💇‍♀️
琴谱	琴谱 🎼️
琴键	琴键 🎹
瑙鲁	瑙鲁 🇳🇷
瑜伽	瑜伽 🧘‍♂️ 🧘‍♀️
瑞典	瑞典 🇸🇪
瑞士	瑞士 🇨🇭
瓢虫	瓢虫 🐞
瓦特	瓦特 ㎺ ㎻ ㎼ ㎽ ㎾ ㎿ ㍗
瓦肯	瓦肯 🖖
瓶子	瓶子 🫙
甘薯	甘薯 🍠
甚么	甚么 😟️
甜品	甜品 🍮
甜椒	甜椒 🫑
甜点	甜点 🍮
甜瓜	甜瓜 🍈
甜筒	甜筒 🍦
甜食	甜食 🍰
生化	生化 ☣️
生日	生日 🎂️
生气	生气 😡 😠 💢
生病	生病 😷
生蚝	生蚝 🦪
用户	用户 👤 👥
甩头	甩头 🫨
田径	田径 🏃🏻
甲虫	甲虫 🪲
申请	申请 🈸
电压	电压 ㎴ ㎵ ㎶ ㎷ ㎸ ㎹
电台	电台 📻
电塔	电塔 🗼️
电容	电容 ㎊ ㎋ ㎌
电工	电工 👨‍🔧 👩‍🔧
电影	电影 🎞
电梯	电梯 🛗
电池	电池 🔋
电流	电流 ㎀ ㎁ ㎂ ㎃ ㎄
电源	电源 🔋 🔌
电灯	电灯 💡
电筒	电筒 🔦
电脑	电脑 🖥
电视	电视 📺
电话	电话 ☎️
电车	电车 🚎
电邮	电邮 📧️
电量	电量 🔋 🪫
电阻	电阻 ㏀ ㏁
男人	男人 👨
男仔	男仔 🧍‍♂️
男厕	男厕 🚹
男同	男同 👨‍❤️‍👨
男士	男士 🚹
男子	男子 👨🏻️
男孩	男孩 👦
男工	男工 👨🏻‍🏭
男巫	男巫 🧙‍♂️
男性	男性 ♂
男星	男星 👨🏻‍🎤
男童	男童 👦🏻️
男装	男装 👕️
男靴	男靴 🥾
男鞋	男鞋 👞
画叉	画叉 ❌ ❎
画家	画家 👨‍🎨 👩‍🎨
画框	画框 🖼
画画	画画 🎨
画笔	画笔 🖌
番茄	番茄 🍅
番薯	番薯 🍠
疑惑	疑惑 😕
疑问	疑问 🤔
疫苗	疫苗 💉️
疲倦	疲倦 😩
疲劳	疲劳 😪
疲惫	疲惫 😫
疼心	疼心 ❤️‍🩹
病了	病了 🚑️ 🤒️
病毒	病毒 🦠
病菌	病菌 🦠
病院	病院 🏥️
痛哭	痛哭 😭
痛心	痛心 ❤️‍🩹
痛苦	痛苦 😧 😬
登山	登山 🧗‍♂️ 🧗‍♀️
白俄	白俄 🇧🇾
白兔	白兔 🐇️
白发	白发 👨‍🦳 👩‍🦳 🦳
白圆	白圆 ⚪️
白子	白子 ⚪
白心	白心 🤍
白方	白方 ◽️
白旗	白旗 🏳
白框	白框 ⬜
白棋	白棋 ⚪
白点	白点 ⚪
白熊	白熊 🐻‍❄️
白珠	白珠 ⚪️
白痴	白痴 🐷️
白目	白目 🙄️
白眼	白眼 🙄
白色	白色 ⚪ ⬜
白花	白花 💮
白菜	白菜 🥬
白领	白领 👨‍💼 👩‍💼
白饭	白饭 🍚️
白鲨	白鲨 🦈
白鼠	白鼠 🐁️
百货	百货 🏬️
的士	的士 🚕 🚖
皇储	皇储 🤴🏻
皇冠	皇冠 👑
皇子	皇子 🤴🏻
皇族	皇族 👑
皮包	皮包 👝
皮卡	皮卡 🛻
皮鞋	皮鞋 👞
皱眉	皱眉 🙍🏻 [皱眉] (･᷄ὢ･᷅)
盆景	盆景 🪴
盆栽	盆栽 🪴
盆浴	盆浴 🛀🏻️ 🛁️
盈月	盈月 🌔️
监听	监听 👁‍🗨️
盒子	盒子 📦
盒饭	盒饭 🍱
盖饭	盖饭 🍛️ 🥘
盘腿	盘腿 🧘‍♂️ 🧘‍♀️
目光	目光 👁️
目标	目标 🎯
盲人	盲人 🧑🏻‍🦯
盲女	盲女 👩🏻‍🦯
盲杖	盲杖 🦯
盲男	盲男 👨🏻‍🦯
直和	直和 ⊕
直尺	直尺 📏
直梯	直梯 🛗
直积	直积 ⊗
直角	直角 ∟ ⊾ ⦝
相似	相似 ≅
相机	相机 📷
相框	相框 🖼️
相爱	相爱 👩‍❤️‍👨
盾牌	盾牌 🛡
省略	省略 ……
眉月	眉月 🌒 🌘
看书	看书 📖️
看守	看守 💂🏻
看看	看看 👀
真好	真好 😀️ 😺️ 🙆🏻
真心	真心 💖️
真棒	真棒 👍
真龙	真龙 🐉️
眨眼	眨眼 😉
眩晕	眩晕 😵 💫
眯眼	眯眼 😝
眼光	眼光 👀️
眼泪	眼泪 😭️ 😢 🥲
眼睛	眼睛 👀 👁
眼镜	眼镜 👓
着急	着急 😟
着火	着火 🔥
着陆	着陆 🛬
睇戏	睇戏 🎬️
睡了	睡了 😴 💤
睡吧	睡吧 😴️
睡眠	睡眠 😴 💤
睡着	睡着 😴 💤
睡莲	睡莲 🪷
睡觉	睡觉 😴 💤 🛌
睡醒	睡醒 ('-ωก̀) (つω｀)～
睰睰	睰睰 💤️
瞌睡	瞌睡 😪
瞎子	瞎子 🧑🏻‍🦯
瞎话	瞎话 🤥
瞪眼	瞪眼 😳️
矩形	矩形 ⬛ ⬜
短刀	短刀 🗡
短剑	短剑 🗡
短袖	短袖 👕
短袜	短袜 🧦
短裤	短裤 🩳
石像	石像 🗿️
石块	石块 🪨
石头	石头 🪨
石油	石油 ⛽
石雕	石雕 🗿️
码农	码农 👨‍💻 👩‍💻
码头	码头 ⚓️
码畜	码畜 👨‍💻 👩‍💻
码表	码表 ⏱️
砂漏	砂漏 ⌛️
砂锅	砂锅 🥘
研究	研究 🧐
砖块	砖块 🧱
砖头	砖头 🧱
破壳	破壳 🐣
破屋	破屋 🏚️
砸了	砸了 😖️
硕鼠	硕鼠 🐀️
硬币	硬币 🪙
硬盘	硬盘 💽
确定	确定 ✅ ✔️
确认	确认 ✅ ✔️
碗勺	碗勺 🥣
碗筷	碗筷 🍽️
碗豆	碗豆 🫛
碗面	碗面 🍜
碧心	碧心 🩵
碰撞	碰撞 💥️
碰杯	碰杯 🍻 🥂
磁力	磁力 🧲
磁带	磁带 📼
磁盘	磁盘 💾️
磁石	磁石 🧲
磁碟	磁碟 💾️
磁铁	磁铁 🧲
磕头	磕头 🙇🏻
礼品	礼品 🎁
礼帽	礼帽 🎩
礼服	礼服 🤵‍♂️
礼物	礼物 🎁
礼花	礼花 🎆 🎇
社会	社会 [社会社会]
祈求	祈求 🙏
祈祷	祈祷 🙏
祈福	祈福 🙏
祖母	祖母 👵
祖父	祖父 👴
祝日	祝日 🎌️
祝福	祝福 ㊗️
祝贺	祝贺 🎉
神庙	神庙 🏛️
神探	神探 🕵🏻
神社	神社 ⛩
神秘	神秘 😶‍🌫️
神龙	神龙 🐉
祭典	祭典 💮️
祷告	祷告 🛐
禁声	禁声 🔇️
禁止	禁止 🚫 🈲
禁烟	禁烟 🚭
禁行	禁行 🚷️
禁言	禁言 🤐
秃头	秃头 👨‍🦲 👩‍🦲 🦲
秃女	秃女 👩🏻‍🦲
秃男	秃男 👨🏻‍🦲
秃顶	秃顶 👨‍🦲 👩‍🦲 🦲
种地	种地 🧑🏻‍🌾
种田	种田 🧑🏻‍🌾
科学	科学 🔬 🧪
秒表	秒表 ⏱
秘密	秘密 🤐 ㊙️
秘语	秘语 👁‍🗨️
秘钥	秘钥 🗝️
秘鲁	秘鲁 🇵🇪
积分	积分 ∫ ∬ ∭ ∮ ∯ ∰ ⨌
稻子	稻子 🌾️
稻田	稻田 🌾️
稻穗	稻穗 🌾
空位	空位 🈳
空巢	空巢 🪹
空杯	空杯 🫗
空碗	空碗 🥣
空轨	空轨 🚟
空集	空集 ∅
窗子	窗子 🪟
窗户	窗户 🪟
窝夫	窝夫 🧇
立定	立定 🧍🏻
立方	立方 ³
竖笛	竖笛 🪈
站台	站台 🚉
站女	站女 🧍🏻‍♀️
站男	站男 🧍🏻‍♂️
站着	站着 🧍‍♂️ 🧍‍♀️
站立	站立 🧍‍♂️ 🧍‍♀️
章节	章节 §
章鱼	章鱼 🐙
竹篮	竹篮 🧺
笑了	笑了 😄️ 😸️
笑哭	笑哭 🤣 😂
笑晕	笑晕 😆
笑死	笑死 😆
笑脸	笑脸 😀
笔电	笔电 💻
笛子	笛子 🪈
笤帚	笤帚 🧹
符号	符号 🔣
笨蛋	笨蛋 🐷️
第一	第一 ☝️
第三	第三 🥉
第二	第二 ✌️
等于	等于 🟰
等号	等号 🟰
答对	答对 ✅
答错	答错 ❌ ❎
筷子	筷子 🥢
简餐	简餐 🥡
算了	算了 😪️ 🙁️
算盘	算盘 🧮
箱子	箱子 📦
篮子	篮子 🧺
篮球	篮球 🏀
米国	米国 🇺🇸
米果	米果 🍘
米饭	米饭 🍚
米饼	米饼 🍘
粉心	粉心 🩷
粑粑	粑粑 💩
粗气	粗气 😤️
粗粮	粗粮 🍠
粪便	粪便 💩️
精灵	精灵 🧚‍♂️ 🧚‍♀️ 🧝‍♂️ 🧝‍♀️
糊涂	糊涂 🥴
糕点	糕点 🍰️
糖果	糖果 🍬
糟糕	糟糕 X﹏X
紧张	紧张 😰
紧急	紧急 🆘️
紫圆	紫圆 🟣
紫心	紫心 💜
紫色	紫色 🟣 🟪
累了	累了 😑️
繁星	繁星 ✨️
纠结	纠结 😖
红中	红中 🀄
红包	红包 🧧
红发	红发 👨‍🦰 👩‍🦰 🦰
红叶	红叶 🍁️
红唇	红唇 💋 👄
红圆	红圆 🔴️
红娘	红娘 💘️
红心	红心 ♥️
红旗	红旗 🇨🇳
红桃	红桃 ♥️
红色	红色 🔴 🟥
红薯	红薯 🍠
红豆	红豆 🫘
红酒	红酒 🍷️
红鹤	红鹤 🦩
红鹳	红鹳 🦩
约旦	约旦 🇯🇴
约等	约等 ≈ ≅
纱丽	纱丽 🥻
纱线	纱线 🧶
纳米	纳米 ㎚
纸巾	纸巾 🧻
纸币	纸币 💵
纸烟	纸烟 🚬
纸箱	纸箱 📦
纸鸢	纸鸢 🪁
纸鹞	纸鹞 🪁
纽埃	纽埃 🇳🇺
纽约	纽约 🗽️
线团	线团 🧶
线虫	线虫 🪱
线轮	线轮 🧵
线轴	线轴 🧵
练腿	练腿 🦵
绅士	绅士 🤵🏻‍♂️
细菌	细菌 🦠
终点	终点 🏁
结他	结他 🎸️
结婚	结婚 💒️
结束	结束 🔚
绘画	绘画 🎨️
给钱	给钱 🤑️
绝了	绝了 👍
统计	统计 📊
绳子	绳子 🪢
绳结	绳结 🪢
绵羊	绵羊 🐑
绷带	绷带 🤕
绿圆	绿圆 🟢
绿帽	绿帽 🪖
绿心	绿心 💚
绿色	绿色 🟢 🟩
绿茶	绿茶 🍵️
绿菜	绿菜 🥬
绿藻	绿藻 🦠
缅甸	缅甸 🇲🇲
缆车	缆车 🚠 🚡
缝纫	缝纫 🪡
缝补	缝补 🪡
缠头	缠头 👳🏾
缺月	缺月 🌖️
罐头	罐头 🥫
罐子	罐子 🫙
网球	网球 🎾
网络	网络 🛜
罗盘	罗盘 🧭
羊排	羊排 🥩
羊羊	羊羊 🐑
羊肉	羊肉 🐏️
羊驼	羊驼 🦙
美元	美元 $ 💵 💲
美刀	美刀 $
美味	美味 😋
美国	美国 🇺🇸
美圆	美圆 💵️
美女	美女 😍️ 😻️
美容	美容 💆‍♂️ 💆‍♀️
美洲	美洲 🌎
美甲	美甲 💅
美金	美金 💵️
美钞	美钞 💵️
羞涩	羞涩 ☺️
羞羞	羞羞 😚️
群岛	群岛 🗾️
羽毛	羽毛 🪶
羽翼	羽翼 🪽
翅膀	翅膀 🪽
翻墙	翻墙 🪜
老人	老人 👴 👵
老倌	老倌 👴🏻️
老太	老太 👵🏻️
老头	老头 👴
老奶	老奶 👵🏻️
老妈	老妈 👩
老师	老师 👨‍🏫 👩‍🏫
老挝	老挝 🇱🇦
老母	老母 👩🏻️
老爸	老爸 👨🏻️
老爹	老爹 👨
老窦	老窦 👨🏻️
老虎	老虎 🐯 🐅
老豆	老豆 👨🏻️
老鹰	老鹰 🦅
老鼠	老鼠 🐭 🐁 🐀
考拉	考拉 🐨
耗子	耗子 🐭 🐁 🐀
耳仔	耳仔 👂🏻
耳放	耳放 🎧️
耳朵	耳朵 👂
耳机	耳机 🎧
耳聋	耳聋 🧏‍♂️ 🧏‍♀️
耸肩	耸肩 🤷‍♂️ 🤷‍♀️
耿西	耿西 🇬🇬
聊天	聊天 💬️
聋哑	聋哑 🧏🏻 🦻🏻
聋女	聋女 🧏🏻‍♀️
聋子	聋子 🧏‍♂️ 🧏‍♀️
聋男	聋男 🧏🏻‍♂️
职员	职员 👨‍💼 👩‍💼
联结	联结 🔗️
聘礼	聘礼 💝️
聚会	聚会 🍻️
聪明	聪明 😇️
肉串	肉串 🍢
肉丸	肉丸 🧆
肉卷	肉卷 🥓
肉排	肉排 🥩
肋排	肋排 🥩
肌肉	肌肉 💪
肤色	肤色 🏻 🏼 🏽 🏾 🏿
肥猪	肥猪 🐖️
肥皂	肥皂 🧼
肯亚	肯亚 🇰🇪
背包	背包 🎒️
背囊	背囊 🎒
背心	背心 🎽️
胖达	胖达 🐼
胜利	胜利 ✌️
胡女	胡女 🧔🏻‍♀️
胡子	胡子 🧔
胡扯	胡扯 🤥
胡男	胡男 🧔🏻‍♂️
胡说	胡说 🤥
胡须	胡须 🧔
胳膊	胳膊 💪 🦾
胶卷	胶卷 🎞
胶囊	胶囊 💊
胶布	胶布 🩹
胶片	胶片 🎞
胸片	胸片 🩻
胸透	胸透 🩻
胸针	胸针 🏵️
脏话	脏话 🤬
脐橙	脐橙 🍊️
脑子	脑子 🧠
脑花	脑花 🧠
脚丫	脚丫 🦶
脚印	脚印 👣
脚底	脚底 🦶🏻
脚掌	脚掌 🦶🏻
脚步	脚步 👣️
脱发	脱发 👨‍🦲 👩‍🦲 🦲
脸红	脸红 😊 😳
腕龙	腕龙 🦕
腿儿	腿儿 🦵
膏布	膏布 🩹
膜拜	膜拜 🙇‍
自信	自信 😎
自恋	自恋 (◡ᴗ◡✿)
自拍	自拍 🤳
自杀	自杀 …〒_〒…‵ｏ′-一┳═┻︻▄
自然	自然 🌃
自由	自由 🆓
臭美	臭美 (o≖◡≖)
臭鼬	臭鼬 🦨
致命	致命 ☠️
致敬	致敬 🫡
舌头	舌头 👅
舒服	舒服 ☺️
舞厅	舞厅 🪩
舞女	舞女 💃
舞娘	舞娘 💃🏻️
舞男	舞男 🕺🏻
舞者	舞者 🕺
舞蹈	舞蹈 💃🏻️
舰长	舰长 🧑🏻‍✈️
船坞	船坞 ⚓️
船帆	船帆 ⛵️
船锚	船锚 ⚓
船长	船长 🧑🏻‍✈️
色子	色子 🎲
色拉	色拉 🥗
艺人	艺人 🧑🏻‍🎨
艺术	艺术 🎨
节哀	节哀 💮️
芒果	芒果 🥭
芙蓉	芙蓉 🌺
芝士	芝士 🧀
芬兰	芬兰 🇫🇮
芭蕾	芭蕾 🩰
花园	花园 ⛲️
花札	花札 🎴
花朵	花朵 🌼
花束	花束 💐
花瓶	花瓶 🏺️
花生	花生 🥜
花痴	花痴 😍
花结	花结 🏵
花菜	花菜 🥦
花钱	花钱 💸
苍蝇	苍蝇 🪰
苏丹	苏丹 🇸🇩
苏虾	苏虾 👶🏻️
苞米	苞米 🌽
苦恼	苦恼 (-'`-;)
苦涩	苦涩 [苦涩]
苦笑	苦笑 😅
苯环	苯环 ⌬ ⏣
英伦	英伦 🇬🇧
英国	英国 🇬🇧
英文	英文 🔠 🔡
英语	英语 🔠 🔡
英里	英里 ㏕
英镑	英镑 £ 💷
英雄	英雄 🦸🏻
苹果	苹果 🍎 🍏
茄子	茄子 🍆
茅屋	茅屋 🛖
茅房	茅房 🚾️ 🛖
茅舍	茅舍 🛖
茈花	茈花 🎇️
茫然	茫然 😳️
茶壶	茶壶 🫖
茶杯	茶杯 🍵
茶水	茶水 🍵
草㡌	草㡌 👒️
草屋	草屋 🛖
草舍	草舍 🛖
草花	草花 ♣️
草药	草药 🌿
草莓	草莓 🍓
荒宅	荒宅 🏚
荒岛	荒岛 🏝
荒漠	荒漠 🏜
药丸	药丸 💊
药草	药草 🌿
荷兰	荷兰 🇳🇱
荷包	荷包 👝
荷花	荷花 🪷
莎丽	莎丽 🥻
莲花	莲花 🪷
获胜	获胜 ヾ(￣ー￣)X(^▽^)ゞ
菊花	菊花 🌼️
菌类	菌类 🍄️
菜刀	菜刀 🔪
菜椒	菜椒 🫑
菜篮	菜篮 🧺
菜花	菜花 🥦
菠萝	菠萝 🍍
菱形	菱形 🔶 🔷
菲林	菲林 🎞
萝卜	萝卜 🥕
营业	营业 🈺
萨巴	萨巴 🇧🇶
落叶	落叶 🍂
落日	落日 🌇
落雪	落雪 🌨️
葛摩	葛摩 🇰🇲
葡国	葡国 🇵🇹
葡币	葡币 MOP$
葡萄	葡萄 🍇
葬礼	葬礼 💮️
葱头	葱头 🧅
葵花	葵花 🌻
蒙古	蒙古 🇲🇳
蒙眼	蒙眼 🙈
蒜香	蒜香 🧄
蒸房	蒸房 🧖‍♂️ 🧖‍♀️
蒸馏	蒸馏 ⚗
蓝圆	蓝圆 🔵️
蓝心	蓝心 💙 🩵
蓝色	蓝色 🔵 🟦
蓝莓	蓝莓 🫐
蓝菱	蓝菱 🔷️
蓝藻	蓝藻 🦠
蔬菜	蔬菜 🥬
蔷薇	蔷薇 🌹️
蕃茄	蕃茄 🍅️
薄饼	薄饼 🍕️ 🥞 🫓
薯仔	薯仔 🥔
薯条	薯条 🍟
蘑菇	蘑菇 🍄
虎头	虎头 🐯
虎年	虎年 🐯️
虎脸	虎脸 🐯
虚伪	虚伪 🥸
虚化	虚化 🫥
虫子	虫子 🐛
虾卷	虾卷 🍤️
虾米	虾米 🍤️
虾蟆	虾蟆 🐸️
蚂蚁	蚂蚁 🐜
蚂蚱	蚂蚱 🦗
蚊子	蚊子 🦟
蚊虻	蚊虻 🦟
蚊蝇	蚊蝇 🦟 🪰
蚊香	蚊香 🌀
蚝蛎	蚝蛎 🦪
蚯蚓	蚯蚓 🪱
蚱蜢	蚱蜢 🦗
蚵仔	蚵仔 🦪
蛇头	蛇头 🐍️
蛇年	蛇年 🐍️
蛇杖	蛇杖 ⚕
蛋治	蛋治 🥪
蛋糕	蛋糕 🎂 🍰
蛋蛋	蛋蛋 🥚
蛋饼	蛋饼 🥞
蛐蛐	蛐蛐 🦗
蛔虫	蛔虫 🪱
蛛网	蛛网 🕸
蛤蛤	蛤蛤 🐸
蛤蟆	蛤蟆 🐸
蜂蜜	蜂蜜 🍯
蜈蚣	蜈蚣 𓆨
蜗牛	蜗牛 🐌
蜘蛛	蜘蛛 🕷
蜙蝑	蜙蝑 🦗
蜜橘	蜜橘 🍊
蜜獾	蜜獾 🦡
蜜瓜	蜜瓜 🍈️
蜜罐	蜜罐 🍯
蜜蜂	蜜蜂 🐝
蜡烛	蜡烛 🕯
蜡笔	蜡笔 🖍
蜥蜴	蜥蜴 🦎
蝈蝈	蝈蝈 🦗
蝌蚪	蝌蚪 𓆐
蝎子	蝎子 🦂
蝙蝠	蝙蝠 🦇
蝴蝶	蝴蝶 🦋
螃蟹	螃蟹 🦀
融化	融化 🫠
螺丝	螺丝 🔩
螺号	螺号 🐚️
螽斯	螽斯 🦗
蟋蟀	蟋蟀 🦗
蟑螂	蟑螂 🪳
蠕虫	蠕虫 🪱
蠢材	蠢材 🐷️
血型	血型 🅰️ 🆎 🅱️ 🅾️
血液	血液 🩸
血滴	血滴 🩸
行人	行人 🚶🏻
行啊	行啊 😉️
行星	行星 🪐
行李	行李 🧳
行走	行走 🚶‍♂️ 🚶‍♀️
衣服	衣服 👔
表扬	表扬 👍
衬衣	衬衣 👔️
衬衫	衬衫 👕
袋鼠	袋鼠 🦘
袜子	袜子 🧦
被骗	被骗 💸️
裁判	裁判 🕴🏻️
裂开	裂开 [裂开]
装傻	装傻 🤪 (´◑д◐｀)
裙子	裙子 👗
裤头	裤头 🩲
裤子	裤子 👖
裹头	裹头 👳🏾
西服	西服 🤵‍♂️
西瓜	西瓜 🍉
西装	西装 🤵🏻
西部	西部 🏜️
要得	要得 👌🏻️
见面	见面 ＼（＾∀＾）メ（＾∀＾）ノ
见鬼	见鬼 😨️
观察	观察 👀
观月	观月 🎑
解锁	解锁 🔓 🔐
触电	触电 ⚡️
言和	言和 🤝🏻
警卫	警卫 💂‍♂
警告	警告 ⚠️
警官	警官 👮‍♂️ 👮‍♀️
警察	警察 👮‍♂️ 👮‍♀️
警灯	警灯 🚨
警车	警车 🚓 🚔
计时	计时 ⏳️
认真	认真 🧐
认输	认输 🏳
讨厌	讨厌 👎
讲话	讲话 🗣
许愿	许愿 🌠
证人	证人 👁️‍🗨️
证件	证件 🪪
证照	证照 🪪
诅咒	诅咒 _〆(´Д｀)
诈骗	诈骗 💸️
词典	词典 📖
试剂	试剂 🧪
试管	试管 🧪
话筒	话筒 🎙️ 🎤️
诞生	诞生 🐣️
诡计	诡计 🌚️ 😏️
语言	语言 🌐️
诱惑	诱惑 🫦
诱饵	诱饵 🪤
说话	说话 💬 🗣️
说谎	说谎 🤥
请女	请女 💁🏻‍♀️
请男	请男 💁🏻‍♂️
诺鲁	诺鲁 🇳🇷
读书	读书 📖️ 🤓️
课堂	课堂 🧑🏻‍🏫
课室	课室 🧑🏻‍🏫
课本	课本 📖️
调亮	调亮 🔆️
调低	调低 🔽
调情	调情 🫦
调暗	调暗 🔅️
调皮	调皮 😜
调羹	调羹 🥄
调色	调色 🎨️
调节	调节 🎚 🎛
调高	调高 🔼
谎话	谎话 🤥
谢谢	谢谢 🙏
谢顶	谢顶 🧑🏻‍🦲
谱曲	谱曲 🎼️
豆子	豆子 🫘
豆荚	豆荚 🫛
豌豆	豌豆 🫛
豪猪	豪猪 🐗️
豹子	豹子 🐆
贝南	贝南 🇧🇯
贝壳	贝壳 🐚
贝宁	贝宁 🇧🇯
贝类	贝类 🐚️
负伤	负伤 🤕
财迷	财迷 🤑
账单	账单 🧾
账本	账本 📒️
账簿	账簿 📒
货卡	货卡 🛻
货币	货币 💲
货车	货车 🚚
货运	货运 🚚️
质量	质量 ㎍ ㎎ ㎏
购物	购物 🛍️ 🛒
贱人	贱人 🤬
费用	费用 🈂
贺礼	贺礼 🎁️
资讯	资讯 ℹ️
资金	资金 💲️
赌博	赌博 🎰 🎲
赌场	赌场 🎰
赌钱	赌钱 🎰️
赌马	赌马 🏇🏻
赏月	赏月 🎑
赛艇	赛艇 🚤
赛车	赛车 🏎
赛马	赛马 🏇
赞同	赞同 (ﾟｰﾟ) ヾ(＠⌒ー⌒＠)ノ
赢了	赢了 ✌️
赢咯	赢咯 ✌️
赢啦	赢啦 ✌️
赤发	赤发 🦰
赤心	赤心 ❤️
赫兹	赫兹 ㎐ ㎑ ㎒ ㎓ ㎔
赭圆	赭圆 🟤
赭心	赭心 🤎
走女	走女 🚶🏻‍♀️
走男	走男 🚶🏻‍♂️
走路	走路 🚶‍♂️ 🚶‍♀️
起司	起司 🧀
起子	起子 🔧️ 🪛
起火	起火 🔥️
起雾	起雾 🌁️
起飞	起飞 🛫
超人	超人 🦸‍♂️ 🦸‍♀️
超市	超市 🏬
超度	超度 🙏
超辣	超辣 🥵
超酷	超酷 🆒
越南	越南 🇻🇳
趋势	趋势 📈 📉
足印	足印 🐾️ 👣️
足球	足球 ⚽
足迹	足迹 👣
跌倒	跌倒 ……]((o__)'彡☆
跑女	跑女 🏃🏻‍♀️
跑步	跑步 🏃‍♂️ 🏃‍♀️
跑男	跑男 🏃🏻 🏃🏻‍♂️
跑车	跑车 🏎️
跑鞋	跑鞋 👟
跑马	跑马 🐎️
跛女	跛女 👩🏻‍🦼 👩🏻‍🦽
跛男	跛男 👨🏻‍🦼 👨🏻‍🦽
距离	距离 ㎙ ㎚ ㎛ ㎜ ㎝ ㎞
跪下	跪下 🧎🏻
跪坐	跪坐 🧎‍♂️ 🧎‍♀️
跪女	跪女 🧎🏻‍♀️
跪拜	跪拜 🙇🏻 🧎🏻
跪求	跪求 🙇‍♂️ 🙇‍♀️
跪男	跪男 🧎🏻‍♂️
路口	路口 🚥️ 🚦️
路障	路障 🚧
跳伞	跳伞 🪂
跳舞	跳舞 💃 🕺
踪迹	踪迹 🐾️
蹙眉	蹙眉 🙍🏻
蹦迪	蹦迪 🪩
身份	身份 🆔
身孕	身孕 🫄🏻
车头	车头 🚆️
车站	车站 🚉
车箱	车箱 🚆️
车胎	车胎 🛞
车轮	车轮 🛞
转上	转上 ⤴️
转下	转下 ⤵️
轮子	轮子 🛞
轮椅	轮椅 🦽 ♿
轮渡	轮渡 ⛴
轮滑	轮滑 🛼
轮胎	轮胎 🛞
轮船	轮船 🚢
软盘	软盘 💾
软碟	软碟 💾️
软饮	软饮 🍹️
轱辘	轱辘 🛞
轻点	轻点 🤫
轻蔑	轻蔑 (´ｰ∀ｰ`)
轻轨	轻轨 🚈
轿车	轿车 🚗 🚘
辐射	辐射 ☢️
辞典	辞典 📖
辣椒	辣椒 🌶
辣死	辣死 🥵
辣鸡	辣鸡 🙃 🚮 🚯
边检	边检 🛂️
边防	边防 🛂️
运动	运动 🏊
运货	运货 🚚️
近视	近视 👓
返回	返回 🔙️
还好	还好 😅
这边	这边 💁🏻
这里	这里 🈁
连接	连接 🔗️
连结	连结 🔗️
迦纳	迦纳 🇬🇭
迪厅	迪厅 🪩
迷恋	迷恋 🥰
迷糊	迷糊 🥴 🫨
退回	退回 🔙
选举	选举 🗳️
选票	选票 🗳
逗号	逗号 ， ,
通过	通过 ✔️
速度	速度 ㎧
道教	道教 ☯️
道歉	道歉 🙇‍♂️ 🙇‍♀️
道观	道观 🛐️
邪恶	邪恶 😈️
邮件	邮件 📧
邮号	邮号 📯️
邮局	邮局 🏣 🏤
邮筒	邮筒 📮
邮箱	邮箱 📮
邮轮	邮轮 🚢
郁闷	郁闷 😒
都市	都市 🏙
都行	都行 😶️
鄙视	鄙视 😒
酒店	酒店 🏨
酒杯	酒杯 🍷
酒盏	酒盏 🥃
酒醉	酒醉 🥴
酷炫	酷炫 😎️
酸碱	酸碱 ㏗
醉了	醉了 🥴
醒目	醒目 😇️
释然	释然 😌
重做	重做 ↪️
重复	重复 々 〻
重拍	重拍 🆖
重点	重点 ※
重要	重要 ※
野牛	野牛 🦬
野狗	野狗 🐕️
野狼	野狼 🐺️
野猪	野猪 🐗
野营	野营 🏕
野马	野马 🐎️
金发	金发 👱 👱‍♀️ 👱‍♂️
金毛	金毛 🦮
金牌	金牌 🥇
金钥	金钥 🔑️
金钱	金钱 💰 💲
针管	针管 💉
针线	针线 🪡
钓竿	钓竿 🎣
钓鱼	钓鱼 🎣
钞票	钞票 💵
钟表	钟表 🕙
钢琴	钢琴 🎹
钢笔	钢笔 ✒️ 🖋
钢镚	钢镚 🪙
钥匙	钥匙 🔑 🗝
钩子	钩子 🪝
钱包	钱包 👛
钱夹	钱夹 👛️
钱币	钱币 🪙
钱眼	钱眼 🤑
钱袋	钱袋 💰
钻戒	钻戒 💍
钻石	钻石 💎
铁塔	铁塔 🗼️
铁索	铁索 ⛓️
铁路	铁路 🛤️
铁轨	铁轨 🛤
铁道	铁道 🛤️
铁钩	铁钩 🪝
铁链	铁链 ⛓️
铁锤	铁锤 🔨
铁镐	铁镐 ⛏️
铃铛	铃铛 🔔
铅笔	铅笔 ✏️
铜牌	铜牌 🥉
银河	银河 🌌
银牌	银牌 🥈
银行	银行 🏦
链子	链子 ⛓️
链接	链接 🔗
链条	链条 ⛓️
锁上	锁上 🔒
锁住	锁住 🔒
锁匙	锁匙 🔑️
锁头	锁头 🔒 🔓
锁链	锁链 ⛓️
锄头	锄头 ⛏️
锅贴	锅贴 🥟
锉冰	锉冰 🍧️
错号	错号 ❌ ❎
错误	错误 ❌ ❎
锡克	锡克 🪯
锤子	锤子 🔨
键板	键板 ⌨️
键盘	键盘 ⌨️
锯子	锯子 🪚
镙丝	镙丝 🔩️
镜子	镜子 🪞
长号	长号 🎺️
长度	长度 ↕️ ㎙ ㎚ ㎛ ㎜ ㎝ ㎞
长笛	长笛 🪈
长者	长者 🧓🏻
长裙	长裙 👗
长裤	长裤 👖️
长靴	长靴 👢
长鼓	长鼓 🪘
长鼔	长鼔 🪘
长鼻	长鼻 🤥
门卫	门卫 💂🏻
门子	门子 🚪
门松	门松 🎍
门票	门票 🎫
门锁	门锁 🔒 🔓
闪亮	闪亮 ✨
闪光	闪光 ✨
闪烁	闪烁 ✨️
闪电	闪电 ⚡
闪耀	闪耀 ✨
闭口	闭口 🫢
闭嘴	闭嘴 🤐
问号	问号 ❓ ❔
间谍	间谍 🕵🏻
闷着	闷着 🤐️
闹表	闹表 ⏰
闹钟	闹钟 ⏰
闹铃	闹铃 ⏰️ 🔔️
闺蜜	闺蜜 👭
阅读	阅读 📖️
防疫	防疫 😷️
阳伞	阳伞 ☂️
阳谋	阳谋 🌝️
阴天	阴天 ⛅
阴暗	阴暗 🌚️
阴谋	阴谋 🌚️
阴阳	阴阳 ☯️
阵列	阵列 📡️
阵雨	阵雨 🌦️
阵风	阵风 💨
阶乘	阶乘 !
阿公	阿公 👴🏻️
阿婆	阿婆 👵🏻️
阿曼	阿曼 🇴🇲
阿爷	阿爷 👴🏻️
阿联	阿联 🇦🇪
降低	降低 🔽️
降号	降号 ♭
降落	降落 🛬
除以	除以 ➗
除号	除号 ➗
陶醉	陶醉 (*︾▽︾)
陷阱	陷阱 🪤
随便	随便 😶️
随机	随机 🔀
隐形	隐形 🫥
隐秘	隐秘 🔏
隐藏	隐藏 🫥
隐身	隐身 😶‍🌫️ 🫥
难受	难受 😣
难吃	难吃 🤢
难想	难想 🤔️
难过	难过 😞
难题	难题 🤔️
雄狮	雄狮 🦁️
雏鸡	雏鸡 🐥️
雕像	雕像 🗽️
雨云	雨云 🌧
雨伞	雨伞 🌂 ☂️ ☔
雪云	雪云 🌨
雪人	雪人 ⛄
雪山	雪山 🏔
雪岭	雪岭 🏔️
雪松	雪松 🎄️
雪橇	雪橇 🛷
雪球	雪球 ⚪
雪糕	雪糕 🍨️ 🧁
雪花	雪花 ❄️
雪靴	雪靴 🎿️
雪顶	雪顶 🏔️
零点	零点 🕛️
零食	零食 🍬 🍭 🍫
雷云	雷云 🌩
雷电	雷电 ⚡
雷达	雷达 📡️
雷雨	雷雨 ⛈️
雷龙	雷龙 🦕
雾气	雾气 🌁
雾都	雾都 🌁
雾霾	雾霾 🌫
震动	震动 📳
震惊	震惊 🤯
震撼	震撼 🗯️
露宿	露宿 ⛺️
露营	露营 🏕
青圆	青圆 🔵️
青心	青心 💙️
青椒	青椒 🫑
青瓜	青瓜 🥒
青筋	青筋 💢
青色	青色 🟦
青菜	青菜 🥬
青虫	青虫 🐛️
青蛙	青蛙 🐸
靓仔	靓仔 👨🏻️
靓女	靓女 👩🏻️
靓瞎	靓瞎 😍️ 😻️
静坐	静坐 🧘🏻
静音	静音 🔇
非洲	非洲 🌍
靠椅	靠椅 🪑
面具	面具 🎭
面包	面包 🍞
面壁	面壁 (￣￣)σ…(＿＿)ノ｜壁
面条	面条 🍜
面积	面积 ㎟ ㎠ ㎡ ㎢
面饼	面饼 🫓
靴子	靴子 👢
靶心	靶心 🎯
鞋子	鞋子 👟
鞠躬	鞠躬 🙇‍♂️ 🙇‍♀️
鞭炮	鞭炮 🧨
韩元	韩元 ₩
韩国	韩国 🇰🇷
音乐	音乐 🎵 🎶
音响	音响 🔈️
音符	音符 🎵 🎶
音箱	音箱 🔈️
音调	音调 ♭ ♮ ♯
音量	音量 🔇 🔈 🔉 🔊
页码	页码 ㌻
页签	页签 📑
须女	须女 🧔🏻‍♀️
须男	须男 🧔🏻‍♂️
顽皮	顽皮 😜️
顿号	顿号 、
预警	预警 ⚠️
领带	领带 👔
频率	频率 ㎐ ㎑ ㎒ ㎓ ㎔
颠倒	颠倒 🙃
颤抖	颤抖 😨 😱
风台	风台 🌀️
风景	风景 🏞️
风暴	风暴 🌀
风筝	风筝 🪁
风衣	风衣 🧥
风铃	风铃 🎐
风鸢	风鸢 🪁
飓风	飓风 🌀
飘舞	飘舞 🍃️
飘落	飘落 🍃️
飘过	飘过 .....((/--)/
飞吻	飞吻 😘
飞奔	飞奔 ─=≡Σ(((つ•̀ω•́)つ
飞弹	飞弹 🚀️
飞机	飞机 ✈️
飞盘	飞盘 🥏
飞碟	飞碟 🛸
飞镖	飞镖 🎯
飞鸟	飞鸟 🐦️
食指	食指 ☝️
食物	食物 🥘 🍲
食盐	食盐 🧂
餐具	餐具 🍽
餐盘	餐盘 🍽️
餐铃	餐铃 🛎️
饭团	饭团 🍙
饭店	饭店 🏨️
饭碗	饭碗 🥣
饮料	饮料 🥤
饮杯	饮杯 🥂
饮物	饮物 🧃
饺子	饺子 🥟
饼干	饼干 🍪
饿了	饿了 😋️
馅饼	馅饼 🥧
香槟	香槟 🍾
香波	香波 🧴
香港	香港 🇭🇰
香烟	香烟 🚬
香瓜	香瓜 🍈️
香皂	香皂 🧼
香草	香草 🌿
香蕉	香蕉 🍌
香锅	香锅 🍲️
马上	马上 🔜
马儿	马儿 🐴 🐎
马利	马利 🇲🇱
马头	马头 🐴
马年	马年 🐴️
马戏	马戏 🎪
马术	马术 🏇🏻
马桶	马桶 🚽
马肉	马肉 🐎️
马脸	马脸 🐴
马蜂	马蜂 🐝️
马里	马里 🇲🇱
马𤠑	马𤠑 🐒️
驴儿	驴儿 🫏
驸马	驸马 🤴🏻
驻车	驻车 🅿️
驼鹿	驼鹿 🫎
驾照	驾照 🪪
骂人	骂人 🤬
骄傲	骄傲 (‾◡◝)
骆驼	骆驼 🐪 🐫
骏马	骏马 🐎
骑行	骑行 🚴🏻
骑车	骑车 🚴‍♂️ 🚴‍♀️
骑马	骑马 🏇
骗人	骗人 🤥
骗子	骗子 🤥
骗钱	骗钱 💸️
骨头	骨头 🦴
骨灰	骨灰 ⚱️
骨骼	骨骼 🦴
骰子	骰子 🎲
骷髅	骷髅 💀 ☠️
高中	高中 🏫️
高兴	高兴 😄
高压	高压 ⚡️
高山	高山 🏔
高帽	高帽 🎩
高度	高度 ↕️
高温	高温 🥵
高烧	高烧 🤒️
高速	高速 🛣
高铁	高铁 🚄 🚅
髯女	髯女 🧔🏻‍♀️
髯男	髯男 🧔🏻‍♂️
鬼怪	鬼怪 👹️ 👺 👻
鬼火	鬼火 👿️ 😡️
鬼牌	鬼牌 🃏
鬼脸	鬼脸 🤪 🥴
鬼话	鬼话 🙄️
鬼魂	鬼魂 👻
魂魄	魂魄 👻️
魔头	魔头 🦹🏻
魔杖	魔杖 🪄 ☤ ‍⚕️
魔棒	魔棒 🪄
魔法	魔法 🧙🏻
魔镜	魔镜 🪞
魔鬼	魔鬼 😈 👿
鰞鱡	鰞鱡 🦑
鰞鲗	鰞鲗 🦑
鱼儿	鱼儿 🐟
鱼板	鱼板 🍥
鱼竿	鱼竿 🎣
鱼类	鱼类 🐟️
鱼饼	鱼饼 🍥
鱿鱼	鱿鱼 🦑
鲜花	鲜花 💐
鲤鱼	鲤鱼 🎏
鲨鱼	鲨鱼 🦈
鲸鱼	鲸鱼 🐳 🐋
鳄梨	鳄梨 🥑
鳄鱼	鳄鱼 🐊
鸟头	鸟头 🐦
鸟居	鸟居 ⛩
鸟巢	鸟巢 🪺
鸟类	鸟类 🐦️
鸟羽	鸟羽 🪶
鸟蛋	鸟蛋 🪺
鸠鸽	鸠鸽 🦤
鸡头	鸡头 🐔
鸡巴	鸡巴 🐔
鸡年	鸡年 🐔️
鸡翅	鸡翅 🍗️
鸡翼	鸡翼 🍗️
鸡肉	鸡肉 🐓️
鸡腿	鸡腿 🍗
鸡蛋	鸡蛋 🥚
鸭子	鸭子 🦆
鸭梨	鸭梨 🍐
鸽子	鸽子 🕊
鹦鹉	鹦鹉 🦜
麋鹿	麋鹿 🦌
麒麟	麒麟 🦄️
麮𪌽	麮𪌽 🥖
麻将	麻将 🀄
麻烦	麻烦 🤦🏻
麻雀	麻雀 🀄️
黄叶	黄叶 🍂️
黄圆	黄圆 🟡
黄心	黄心 💛
黄昏	黄昏 🌆
黄榄	黄榄 🫒
黄油	黄油 🧈
黄瓜	黄瓜 🥒
黄色	黄色 🟡 🟨
黄菱	黄菱 🔶️
黄蜂	黄蜂 🐝️
黑八	黑八 🎱
黑圆	黑圆 ⚫️
黑子	黑子 ⚫
黑山	黑山 🇲🇪
黑心	黑心 🖤
黑方	黑方 ◾️
黑旗	黑旗 🏴
黑桃	黑桃 ♠️
黑框	黑框 ⬛
黑棋	黑棋 ⚫
黑点	黑点 ⚫
黑猫	黑猫 🐈‍⬛
黑珠	黑珠 ⚫️
黑色	黑色 ⚫ ⬛
黑鸟	黑鸟 🐦‍⬛
鼅鼄	鼅鼄 🕷️
鼓掌	鼓掌 👏
鼔点	鼔点 🥁
鼠头	鼠头 🐭
鼠年	鼠年 🐭️
鼠标	鼠标 🖱
鼠脸	鼠脸 🐭
鼻子	鼻子 👃
鼻涕	鼻涕 🤧
鼻炎	鼻炎 🤧
齿轮	齿轮 ⚙️
龇牙	龇牙 😬
龙头	龙头 🐲
龙年	龙年 🐲️
龙王	龙王 🐲
龙虾	龙虾 🦞
一个人	一个人 👤️
一分钟	一分钟 ☝🏻️
一只眼	一只眼 👁
一壶茶	一壶茶 🫖
一定女	一定女 🙆🏻‍♀️
一定男	一定男 🙆🏻‍♂️
一家人	一家人 👨‍👩‍👦 👨‍👩‍👧 👨‍👩‍👧‍👦 👨‍👩‍👦‍👦 👨‍👩‍👧‍👧
一小会	一小会 ☝🏻️
一小撮	一小撮 🤌🏻
一幅画	一幅画 🖼
一摞书	一摞书 📚️
一束花	一束花 💐️
一条蛇	一条蛇 🐍
一条龙	一条龙 🐉
一杯奶	一杯奶 🥛
一杯酒	一杯酒 🥃
一滴水	一滴水 💧
一点儿	一点儿 🤏
一点半	一点半 🕜
一点点	一点点 🤏
一点钟	一点钟 🕐
一百分	一百分 💯
一碗面	一碗面 🍜
一碗饭	一碗饭 🍚️
一群人	一群人 👥️
一边去	一边去 😛️
一阵间	一阵间 ☝🏻️
七夕树	七夕树 🎋
七夕节	七夕节 🎋
七点半	七点半 🕢
七点钟	七点钟 🕖
万圣节	万圣节 🎃
万那杜	万那杜 🇻🇺
三分裤	三分裤 🩳
三叉戟	三叉戟 🔱
三叶草	三叶草 ☘
三戟叉	三戟叉 🔱️
三文治	三文治 🥙 🥪
三明治	三明治 🥪
三点半	三点半 🕞
三点式	三点式 👙
三点装	三点装 👙️
三点钟	三点钟 🕒
三脚鸡	三脚鸡 🛺
三角尺	三角尺 📐
三角形	三角形 🔺 🔻
三角旗	三角旗 🚩
三角板	三角板 📐
三角裤	三角裤 🩲
三蹦子	三蹦子 🛺
三轮车	三轮车 🛺
上一首	上一首 ⏮️
上三角	上三角 🔼
上厕所	上厕所 🚾️
上弦月	上弦月 🌓 🌛
上班族	上班族 👨‍💼
上箭头	上箭头 ⬆️ ↑
上课女	上课女 👩🏻‍🏫
上课男	上课男 👨🏻‍🏫
下一首	下一首 ⏭️
下三角	下三角 🔽
下午好	下午好 🙂️
下大雨	下大雨 ⛈️
下弦月	下弦月 🌗 🌜
下水道	下水道 🕳
下箭头	下箭头 ⬇️ ↓
下跪女	下跪女 🧎🏻‍♀️
下跪男	下跪男 🧎🏻‍♂️
不一定	不一定 😕️
不会吧	不会吧 😟️ 😦️
不会啦	不会啦 😝️
不关心	不关心 🤷‍♂️ 🤷‍♀️
不准听	不准听 🙉️
不准看	不准看 🙈️
不准说	不准说 🙊️
不可以	不可以 🙅‍♂️ 🙅‍♀️
不可能	不可能 😛️ 😟️
不同意	不同意 🙅‍♂️ 🙅‍♀️
不喜欢	不喜欢 🥴
不好吧	不好吧 😰️
不好女	不好女 🙅🏻‍♀️
不好玩	不好玩 😝️ 😴️
不好男	不好男 🙅🏻‍♂️
不对吧	不对吧 🤨
不属于	不属于 ∉ ∌
不干女	不干女 🙅🏻‍♀️
不干男	不干男 🙅🏻‍♂️
不开心	不开心 🙁
不敢听	不敢听 🙉️
不敢看	不敢看 🫣
不敢说	不敢说 🙊️
不明白	不明白 🤔
不是吧	不是吧 😒
不晓得	不晓得 😲️
不清楚	不清楚 😲️ 🤷🏻‍♂️
不理解	不理解 🤔
不知道	不知道 🤷‍♂️ 🤷‍♀️
不确定	不确定 🫤
不等于	不等于 ≠
不管女	不管女 🤷🏻‍♀️
不管男	不管男 🤷🏻‍♂️
不能听	不能听 🙉️
不能看	不能看 🙈️
不能说	不能说 🤐
不行女	不行女 🙅🏻‍♀️
不行男	不行男 🙅🏻‍♂️
不要怕	不要怕 🤗️
不要说	不要说 🤐
不许听	不许听 🙉️
不许看	不许看 🙈️
不许说	不许说 🙊️
不说了	不说了 🫢
不错啊	不错啊 😀️ 😺️
不高兴	不高兴 🙁
丑小鸭	丑小鸭 🦢
专家女	专家女 👩🏻‍🔬
专家男	专家男 👨🏻‍🔬
丘比特	丘比特 💘
东京塔	东京塔 🗼
东帝汶	东帝汶 🇹🇱
东正教	东正教 ☦️
丢垃圾	丢垃圾 🚮
两点半	两点半 🕝
两点钟	两点钟 🕑
两颗心	两颗心 💕
中产女	中产女 👩🏻‍💼
中产男	中产男 👨🏻‍💼
中午好	中午好 🙂️
中国帽	中国帽 👲
中国龙	中国龙 🐲
中方块	中方块 ◼ ◻
中秋节	中秋节 🎑
丰收饼	丰收饼 🥮
为甚么	为甚么 🤔️
主厨女	主厨女 👩🏻‍🍳
主厨男	主厨男 👨🏻‍🍳
举中指	举中指 🖕
举双手	举双手 🙌
举白旗	举白旗 🏳
举重女	举重女 🏋🏻‍♀️
举重男	举重男 🏋🏻‍♂️
举铁女	举铁女 🏋🏻‍♀️
举铁男	举铁男 🏋🏻‍♂️
举黑旗	举黑旗 🏴
么么哒	么么哒 💋
义大利	义大利 🇮🇹
乌克兰	乌克兰 🇺🇦
乌干达	乌干达 🇺🇬
乌拉圭	乌拉圭 🇺🇾
乌索普	乌索普 🤥
乒乓球	乒乓球 🏓
乔治亚	乔治亚 🇬🇪
乖孩子	乖孩子 🤓️
乖宝宝	乖宝宝 👶
乘雪橇	乘雪橇 🛷
九点半	九点半 🕤
九点钟	九点钟 🕘
书名号	书名号 《》《 》
书呆子	书呆子 🤓
乳液瓶	乳液瓶 🧴
二头肌	二头肌 💪
亏凸月	亏凸月 🌖
五弦琴	五弦琴 🪕
五点半	五点半 🕠
五点钟	五点钟 🕔
五线谱	五线谱 🎼
五角星	五角星 ⭐
井号键	井号键 #️⃣
亚森欣	亚森欣 🇸🇭
交叉旗	交叉旗 🎌
交通灯	交通灯 🚥 🚦
亮度低	亮度低 🔅
亮度高	亮度高 🔆
亮蛋女	亮蛋女 👩🏻‍🦲
亮蛋男	亮蛋男 👨🏻‍🦲
亲一个	亲一个 😙️ 😽️
亲亲猫	亲亲猫 😽
人字拖	人字拖 🩴
人民币	人民币 ￥
人鱼女	人鱼女 🧜🏻‍♀️
人鱼男	人鱼男 🧜🏻‍♂️
仓鼠头	仓鼠头 🐹
仓鼠脸	仓鼠脸 🐹
仙人女	仙人女 🧚🏻‍♀️
仙人掌	仙人掌 🌵
仙人男	仙人男 🧚🏻‍♂️
仙女棒	仙女棒 🎇️
以色列	以色列 🇮🇱
企鹅头	企鹅头 🐧
伊拉克	伊拉克 🇮🇶
伊斯兰	伊斯兰 ☪️
休息室	休息室 🚻
休旅车	休旅车 🚙️
休闲车	休闲车 🚙
休闲鞋	休闲鞋 👟
传呼机	传呼机 📟
传真机	传真机 📠
伯利兹	伯利兹 🇧🇿
伸懒腰	伸懒腰 ٩(๑´0`๑)۶
低亮度	低亮度 🔅
低电量	低电量 🪫
低音量	低音量 🔉️
住宅区	住宅区 🏘️
住宅楼	住宅楼 🏠
佐料瓶	佐料瓶 🧂
体操女	体操女 🤸🏻‍♀️
体操男	体操男 🤸🏻‍♂️
体温计	体温计 🤒
体育场	体育场 🏟
体育馆	体育馆 🏟
佛得角	佛得角 🇨🇻
你也是	你也是 😏️ 😼️
你大爷	你大爷 🤬
你妈屄	你妈屄 🤬
你自己	你自己 🫵
侦探女	侦探女 🕵🏻‍♀️
侦探男	侦探男 🕵🏻‍♂️
侧手翻	侧手翻 🤸‍♂️ 🤸‍♀️
便利店	便利店 🏪
便当盒	便当盒 🍱
俄罗斯	俄罗斯 🇷🇺
保险丝	保险丝 ⏛
保龄球	保龄球 🎳
信号灯	信号灯 🚥 🚦
信用卡	信用卡 💳
俩叹号	俩叹号 ‼️
修理工	修理工 👨‍🔧 👩‍🔧
倒三角	倒三角 🔻
倒垃圾	倒垃圾 🚮
借记卡	借记卡 💳
做指甲	做指甲 💅
做礼拜	做礼拜 🛐️
做美甲	做美甲 💅
做造型	做造型 💇‍♂️ 💇‍♀️
停车场	停车场 🅿️
偷偷看	偷偷看 🫣
偷偷瞧	偷偷瞧 🫣
储蓄卡	储蓄卡 💳️
傻瓜脸	傻瓜脸 🤪
僵尸女	僵尸女 🧟‍♀️
僵尸男	僵尸男 🧟‍♂️
儿童女	👧
儿童男	👦
光头女	光头女 👩‍🦲
光头男	光头男 👨‍🦲
光明节	光明节 🕎
克尔白	克尔白 🕋
免打扰	免打扰 🔕️
兔先生	兔先生 👯‍♂️
兔女郎	兔女郎 👯‍♀️
兔子头	兔子头 🐰
兔子脸	兔子脸 🐰
兔耳朵	兔耳朵 👯‍♂️ 👯‍♀️
入场券	入场券 🎟
八带鱼	八带鱼 🐙️
八点半	八点半 🕣
八点钟	八点钟 🕗
八爪鱼	八爪鱼 🐙️
八角星	八角星 ✴️
八边形	八边形 🛑
公事包	公事包 💼
公交站	公交站 🚏
公交车	公交车 🚌 🚍
公文包	公文包 💼
公车站	公车站 🚏️
六六六	六六六 🤙
六点半	六点半 🕡
六点钟	六点钟 🕕
六芒星	六芒星 🔯
六角星	六角星 🔯
六边形	六边形 ⎔
兰花指	兰花指 🤌
共产党	共产党 ☭
关东煮	关东煮 🍢
冇眼睇	冇眼睇 🙈️
冈比亚	冈比亚 🇬🇲
写作业	写作业 📝️
写字板	写字板 📋
写字楼	写字楼 🏢
军功章	军功章 🎖
农户女	农户女 👩🏻‍🌾
农户男	农户男 👨🏻‍🌾
农民女	农民女 👩🏻‍🌾
农民工	农民工 👷‍♂️ 👷‍♀️
农民男	农民男 👨🏻‍🌾
冥想女	冥想女 🧘🏻‍♀️
冥想男	冥想男 🧘🏻‍♂️
冰淇淋	冰淇淋 🍦 🍨
冰激凌	冰激凌 🍦 🍨
冰激淋	冰激淋 🍨️
冲浪女	冲浪女 🏄🏻‍♀️
冲浪男	冲浪男 🏄🏻‍♂️
冲浪者	冲浪者 🏄‍♂️ 🏄‍♀️
冷冰冰	冷冰冰 🥶
冻僵了	冻僵了 🥶
几内亚	几内亚 🇬🇳
凤尾蝶	凤尾蝶 🦋
出事了	出事了 🚨️
出洋相	出洋相 🤡
出租车	出租车 🚕 🚖
击剑者	击剑者 🤺
划船女	划船女 🚣🏻‍♀️
划船男	划船男 🚣🏻‍♂️
划艇女	划艇女 🚣🏻‍♀️
划艇男	划艇男 🚣🏻‍♂️
列印机	列印机 🖨️
刚果布	刚果布 🇨🇬
刚果金	刚果金 🇨🇩
创可贴	创可贴 🩹
利比亚	利比亚 🇱🇾
别乱讲	别乱讲 🙊️
别乱说	别乱说 🙊️
别出声	别出声 🤫
别在意	别在意 🙏🏻
别墅区	别墅区 🏘️
别烦我	别烦我 😑️
别理我	别理我 😑️
别说了	别说了 🤐️ 🫢
别说话	别说话 🤫
别骗我	别骗我 😳️
刮胡刀	刮胡刀 🪒
剃头女	剃头女 💇🏻‍♀️
剃头男	剃头男 💇🏻‍♂️
剃须刀	剃须刀 🪒
剪刀手	剪刀手 ✌️
剪切板	剪切板 📋️
剪发女	剪发女 💇🏻‍♀️
剪发男	剪发男 💇🏻‍♂️
剪头发	剪头发 💇‍♂️ 💇‍♀️
剪贴板	剪贴板 📋
办公楼	办公楼 🏢
加冕女	加冕女 👸🏻
加冕男	加冕男 🤴🏻
加勒比	加勒比 🇧🇶
加拿大	加拿大 🇨🇦
加油站	加油站 ⛽
加速度	加速度 ㎨
助听器	助听器 🦻
劳工女	劳工女 👩🏻‍🏭
劳工男	劳工男 👨🏻‍🏭
包装盒	包装盒 🎁
匈牙利	匈牙利 🇭🇺
化妆室	化妆室 🚻️
化学家	化学家 👨‍🔬 👩‍🔬
化粧室	化粧室 🚻️
北朝鲜	北朝鲜 🇰🇵
北极熊	北极熊 🐻‍❄️
匹诺曹	匹诺曹 🤥
医生女	医生女 👩🏻‍⚕️
医生男	医生男 👨🏻‍⚕️
医者女	医者女 👩🏻‍⚕️
医者男	医者男 👨🏻‍⚕️
十一点	十一点 🕚
十二点	十二点 🕛
十八禁	十八禁 🔞
十字架	十字架 ✝️
十字镐	十字镐 ⛏️
十点半	十点半 🕥
十点钟	十点钟 🕙
升降机	升降机 🛗
半兽人	半兽人 🧌
半身像	半身像 👤 👥
华夫饼	华夫饼 🧇
华氏度	华氏度 ℉
单选框	单选框 🔘
卖艺女	卖艺女 🤹🏻‍♀️
卖艺男	卖艺男 🤹🏻‍♂️
南朝鲜	南朝鲜 🇰🇷
南极洲	南极洲 🇦🇶
南瓜人	南瓜人 🎃️
南瓜头	南瓜头 🎃
南瓜灯	南瓜灯 🎃
南瓜脸	南瓜脸 🎃️
南苏丹	南苏丹 🇸🇸
博士女	博士女 👩🏻‍🎓
博士男	博士男 👨🏻‍🎓
博奈尔	博奈尔 🇧🇶
博物馆	博物馆 🏛
卡塔尔	卡塔尔 🇶🇦
卡士达	卡士达 🍮️
卡片盒	卡片盒 🗃
卡路里	卡路里 ㎈ ㎉ ㌍
卢安达	卢安达 🇷🇼
卢旺达	卢旺达 🇷🇼
卢森堡	卢森堡 🇱🇺
卫士女	卫士女 💂🏻‍♀️
卫士男	卫士男 💂🏻‍♂️
卫生纸	卫生纸 🧻
卫生间	卫生间 🚻 🚾
卫门女	卫门女 💂🏻‍♀️
卫门男	卫门男 💂🏻‍♂️
印刷机	印刷机 🖨
印度庙	印度庙 🛕
印度教	印度教 🕉️ 🛕
卷发女	卷发女 👩‍🦱
卷曲环	卷曲环 ➰
卷毛狗	卷毛狗 🐩
厄瓜多	厄瓜多 🇪🇨
压路机	压路机 🚜️
厕所泵	厕所泵 🪠
原子弹	原子弹 ☢️
原子笔	原子笔 🖊️
原子能	原子能 ⚛️
原谅我	原谅我 🙏🏻️
厨子女	厨子女 👩🏻‍🍳
厨子男	厨子男 👨🏻‍🍳
厨师女	厨师女 👩🏻‍🍳
厨师男	厨师男 👨🏻‍🍳
参禅女	参禅女 🧘🏻‍♀️
参禅男	参禅男 🧘🏻‍♂️
双人像	双人像 👥
双叹号	双叹号 ‼️
双子座	双子座 ♊
双耳瓶	双耳瓶 🏺
双肩包	双肩包 🎒
双胞胎	双胞胎 👨‍👩‍👦‍👦 👨‍👩‍👧‍👦 👨‍👩‍👧‍👧
双鱼座	双鱼座 ♓
发件匣	发件匣 📤️
发件箱	发件箱 📤
发传真	发传真 📠
发红包	发红包 🧧
发邮件	发邮件 📤
取款机	取款机 🏧
受伤了	受伤了 🤕️
变形虫	变形虫 🦠
叙利亚	叙利亚 🇸🇾
古建筑	古建筑 🏛
可回收	可回收 ♻️
台式机	台式机 🖥️
史巴克	史巴克 🖖🏻️
史波克	史波克 🖖🏻️
右勾拳	右勾拳 🤛🏻
右向拳	右向拳 🤜
右手边	右手边 👉🏻️
右箭头	右箭头 ➡️ →
右钩拳	右钩拳 🤛
叹问号	叹问号 ⁉️
吃比萨	吃比萨 🍕
各种星	各种星 ★ ☆ ⛤ ⛥ ⛦ ⛧ ✡ ❋ ❊ ❉ ❈ ❇ ❆ ❅ ❄ ❃ ❂ ❁ ❀ ✿ ✾ ✽ ✼ ✻ ✺ ✹ ✸ ✷ ✶ ✵ ✴ ✳ ✲ ✱ ✰ ✯ ✮ ✭ ✬ ✫ ✪ ✩ ✧ ✦ ✥ ✤ ✣ ✢
各种车	各种车 🚗️ 🚕 🚙 🚌 🚎 🏎 🚓 🚑 🚒 🚐 🚚 🚛 🛻 🚔 🚍 🚘 🚖 🛺
吉布地	吉布地 🇩🇯
吉布提	吉布提 🇩🇯
同学女	同学女 👩🏻‍🎓
同学男	同学男 👨🏻‍🎓
同性恋	同性恋 👨‍❤️‍👨 👩‍❤️‍👩
同性旗	同性旗 🏳️‍🌈
吐出来	吐出来 🤮
吐瓦鲁	吐瓦鲁 🇹🇻
吐舌头	吐舌头 😛 😜 😝
向上指	向上指 👆
向下指	向下指 👇
向右指	向右指 👉
向右推	向右推 🫸
向左指	向左指 👈
向左推	向左推 🫷
向日葵	向日葵 🌻
向钱看	向钱看 🤑️
向阳花	向阳花 🌻
吓死了	吓死了 😱
听不懂	听不懂 😵️
听不见	听不见 🧏🏻 🙉
听唔到	听唔到 🙉️
听诊器	听诊器 🩺
听音乐	听音乐 🎧️
吸管杯	吸管杯 🥤
吸血鬼	吸血鬼 🧛‍♂️ 🧛‍♀️
吸铁石	吸铁石 🧲
吹口气	吹口气 🌬
呜呜呜	呜呜呜 😖️
和平鸽	和平鸽 🕊️
咖啡杯	咖啡杯 ☕
咖喱饭	咖喱饭 🍛
咧嘴笑	咧嘴笑 😁
咬嘴唇	咬嘴唇 🫦
哈哈哈	哈哈哈 🤣
哈密瓜	哈密瓜 🍈
哈萨克	哈萨克 🇰🇿
哥俩好	哥俩好 👬🏻️
哥布林	哥布林 👺
哭泣猫	哭泣猫 😿
唔好讲	唔好讲 🙊️
唔畀听	唔畀听 🙉️
唔畀睇	唔畀睇 🙈️
唔畀讲	唔畀讲 🙊️
唔知女	唔知女 🤷🏻‍♀️
唔知男	唔知男 🤷🏻‍♂️
啤酒肚	啤酒肚 🫃
啦啦队	啦啦队 👯🏻 🥳
啪啪啪	啪啪啪 👏
喀麦隆	喀麦隆 🇨🇲
喂奶女	喂奶女 👩🏻‍🍼
喂奶男	喂奶男 👨🏻‍🍼
喇叭筒	喇叭筒 📣
喜欢你	喜欢你 😍️ 😻️
喜马红	喜马红 🧉
喝咖啡	喝咖啡 ☕
喝多了	喝多了 🥴
喝醉了	喝醉了 🥴
喵喵叫	喵喵叫 🐱
喵喵喵	喵喵喵 🐱
嘟嘟车	嘟嘟车 🛺
噘嘴女	噘嘴女 🙎🏻‍♀️
噘嘴猫	噘嘴猫 😾
噘嘴男	噘嘴男 🙎🏻‍♂️
四叶草	四叶草 🍀
四方帽	四方帽 🎓
四点半	四点半 🕟
四点钟	四点钟 🕓
四脚蛇	四脚蛇 🦎
四角裤	四角裤 🩳
四边形	四边形 ⎕ ⏥
回力棒	回力棒 🪃
回力镖	回力镖 🪃
回形针	回形针 📎 🖇
回旋镖	回旋镖 🪃
回电话	回电话 🤙
团圆饼	团圆饼 🥮
国民党	国民党 ❂
图瓦卢	图瓦卢 🇹🇻
圆图钉	圆图钉 📍
圆珠笔	圆珠笔 🖊
圆白菜	圆白菜 🥬
土库曼	土库曼 🇹🇲
土耳其	土耳其 🇹🇷
圣甲虫	圣甲虫 🪲
圣诞岛	圣诞岛 🇨🇽
圣诞树	圣诞树 🎄
圣诞节	圣诞节 🎅 🤶 🧑‍🎄
圣马丁	圣马丁 🇸🇽
圭亚那	圭亚那 🇬🇾
地下铁	地下铁 🚇️
地球仪	地球仪 🌍 🌎 🌏
场记板	场记板 🎬
坏蛋女	坏蛋女 🦹🏻‍♀️
坏蛋男	坏蛋男 🦹🏻‍♂️
坐轮椅	坐轮椅 👨‍🦽
坐雪橇	坐雪橇 🛷
垃圾桶	垃圾桶 🗑
垃圾筒	垃圾筒 🗑️
垃圾篓	垃圾篓 🗑
培养基	培养基 🧫
培养皿	培养皿 🧫
基督教	基督教 ✝️
堆雪人	堆雪人 ⛄
堵耳朵	堵耳朵 🙉
塔吉克	塔吉克 🇹🇯
塞席尔	塞席尔 🇸🇨
塞舌尔	塞舌尔 🇸🇨
墨西哥	墨西哥 🇲🇽
壁炉钟	壁炉钟 🕰
处女座	处女座 ♍
备忘录	备忘录 📝
复活岛	复活岛 🗿
复选框	复选框 ☑️
外卖桶	外卖桶 🥡
外卖盒	外卖盒 🥡
外星人	外星人 👽
外蒙古	外蒙古 🇲🇳
多选框	多选框 ☑️
夜总会	夜总会 🪩
大公鸡	大公鸡 🐓
大卡车	大卡车 🚛
大厨女	大厨女 👩🏻‍🍳
大厨男	大厨男 👨🏻‍🍳
大反派	大反派 🦹‍♂️ 🦹‍♀️
大喇叭	大喇叭 📣
大头针	大头针 📍
大头钉	大头钉 📌️
大学生	大学生 👨‍🎓 👩‍🎓
大小王	大小王 🃏
大拇指	大拇指 👍 👎
大方块	大方块 ◾ ◽
大母鸡	大母鸡 🐓
大法官	大法官 🧑🏻‍⚖️
大洋洲	大洋洲 🌏️
大灰狼	大灰狼 🐺️
大熊猫	大熊猫 🐼
大状女	大状女 👩🏻‍⚖️
大状男	大状男 👨🏻‍⚖️
大猩猩	大猩猩 🦍
大白兔	大白兔 🐇
大白菜	大白菜 🥬
大白鲨	大白鲨 🦈
大米饭	大米饭 🍚
大老鼠	大老鼠 🐀️
大肚子	大肚子 🤰 🫃
大胡子	大胡子 🧔🏻
大菱形	大菱形 🔶 🔷
大野牛	大野牛 🦬
大闸蟹	大闸蟹 🦀️
大音量	大音量 🔊
大麻烦	大麻烦 🤦🏻
天妇罗	天妇罗 🍤
天枰座	天枰座 ♎️
天秤座	天秤座 ♎
天蝎座	天蝎座 ♏
太可怕	太可怕 😨️
太好了	太好了 🙆🏻
太差了	太差了 👎
太差啦	太差啦 👎
太感谢	太感谢 🙏🏻️
太棒了	太棒了 👍
太棒啦	太棒啦 👍
太空人	太空人 🧑🏻‍🚀
太阳㡌	太阳㡌 🧢
太阳伞	太阳伞 🏖
太阳神	太阳神 🌞️
太阳花	太阳花 🌻
太阳菊	太阳菊 🌼️
太阳镜	太阳镜 😎 🕶
太难了	太难了 😵️
失聪者	失聪者 🧏‍♂️ 🧏‍♀️
头大女	头大女 🤦🏻‍♀️
头大男	头大男 🤦🏻‍♂️
头巾女	头巾女 👳🏾‍♀️
头巾男	头巾男 👳🏾‍♂️
头爆炸	头爆炸 🤯
头疼女	头疼女 🤦🏻‍♀️
头疼男	头疼男 🤦🏻‍♂️
夹克衫	夹克衫 🧥
奇异果	奇异果 🥝
奇怪了	奇怪了 🤔
奔跑女	奔跑女 🏃🏻‍♀️
奔跑男	奔跑男 🏃🏻‍♂️
奥地利	奥地利 🇦🇹
女丧尸	女丧尸 🧟‍♀️
女侦探	女侦探 🕵️‍♀️
女僵尸	女僵尸 🧟‍♀️
女儿节	女儿节 🎎️
女医生	女医生 👩‍⚕️
女卫兵	女卫兵 💂‍♀️
女卫士	女卫士 💂‍♀️
女厕所	女厕所 🚺
女厨师	女厨师 👩‍🍳
女反派	女反派 🦹‍♀️
女坏蛋	女坏蛋 🦹‍♀️
女大夫	女大夫 👩‍⚕️
女学生	女学生 👩‍🎓
女工人	女工人 👷‍♀️
女技工	女技工 👩‍🔧
女教师	女教师 👩‍🏫
女新郎	女新郎 🤵‍♀️
女歌手	女歌手 👩‍🎤
女法官	女法官 👩‍⚖️
女法师	女法师 🧙‍♀️
女灯神	女灯神 🧞‍♀️
女电工	女电工 👩‍🔧
女画家	女画家 👩‍🎨
女白领	女白领 👩‍💼
女码农	女码农 👩‍💻
女码畜	女码畜 👩‍💻
女精灵	女精灵 🧝‍♀️
女老师	女老师 👩‍🏫
女职员	女职员 👩‍💼
女衬衫	女衬衫 👚
女警官	女警官 👮‍♀️
女警察	女警察 👮‍♀️
女超人	女超人 🦸‍♀️
好兄弟	好兄弟 👬
好可怕	好可怕 😨️
好基友	好基友 👬
好复杂	好复杂 🤔️
好好笑	好好笑 😆️
好学生	好学生 🤓️
好崇拜	好崇拜 🤩
好无聊	好无聊 😴️
好纠结	好纠结 😂️ 😹️
好难过	好难过 😩️
妊娠女	妊娠女 🤰🏻
妊娠男	妊娠男 🫃🏻
姓名牌	姓名牌 📛
委屈女	委屈女 🙎🏻‍♀️
委屈男	委屈男 🙎🏻‍♂️
威士忌	威士忌 🥃
威尔士	威尔士 🏴󠁧󠁢󠁷󠁬󠁳󠁿
娥眉月	娥眉月 🌒️
婚纱男	婚纱男 👰🏻‍♂️
子午线	子午线 🌐
子弹头	子弹头 🚅️
孟加拉	孟加拉 🇧🇩
学士女	学士女 👩🏻‍🎓
学士帽	学士帽 🎓
学士男	学士男 👨🏻‍🎓
学生女	学生女 👩🏻‍🎓
学生男	学生男 👨🏻‍🎓
孵化器	孵化器 🐣️
宇航员	宇航员 👨‍🚀 👩‍🚀
守卫女	守卫女 💂🏻‍♀️
守卫男	守卫男 💂🏻‍♂️
安全帽	安全帽 ⛑️
安哥拉	安哥拉 🇦🇴
安圭拉	安圭拉 🇦🇮
安道尔	安道尔 🇦🇩
定时器	定时器 ⏲
实验服	实验服 🥼
宠物犬	宠物犬 🐕‍🦺
宠物狗	宠物狗 🐕‍🦺
室女座	室女座 ♍️
害怕猫	害怕猫 🙀
家禽腿	家禽腿 🍗
宽檐帽	宽檐帽 👒
寄生虫	寄生虫 🪱
富士山	富士山 🗻
对不对	对不对 😈️
对不起	对不起 🙇‍♂️ 🙇‍♀️
对话框	对话框 💬 🗯 💭
寻呼机	寻呼机 📟
导盲杖	导盲杖 🦯
导盲犬	导盲犬 🦮
射手座	射手座 ♐
将军肚	将军肚 🫃
小三角	小三角 🔺️ 🔻️
小丑牌	小丑牌 🃏
小丑脸	小丑脸 🤡
小仙女	小仙女 🧚‍♀️
小仙子	小仙子 🧚‍♂️ 🧚‍♀️
小兔子	小兔子 🐇
小公主	小公主 👸
小圆点	小圆点 ⚪
小声点	小声点 🤫
小天使	小天使 👼
小女孩	小女孩 👧
小孩儿	小孩儿 🧒
小孩子	小孩子 🧒
小宝贝	小宝贝 👶
小推车	小推车 🛒
小提琴	小提琴 🎻
小方块	小方块 ▪ ▫
小方片	小方片 🔸 🔹
小朋友	小朋友 🧒
小气鬼	小气鬼 🙁️
小汽车	小汽车 🚗 🚘
小浣熊	小浣熊 🦝
小点声	小点声 🤫
小猫咪	小猫咪 🐱 🐈
小王子	小王子 🤴
小电驴	小电驴 🛵
小男孩	小男孩 👦
小白兔	小白兔 🐇
小白方	小白方 ▫️
小白框	小白框 ⬜
小白点	小白点 ⚪
小白菜	小白菜 🥬
小白鼠	小白鼠 🐁
小盆友	小盆友 🧒
小精灵	小精灵 🧚‍♂️ 🧚‍♀️
小红书	小红书 📕
小苹果	小苹果 🍎 🍏
小菱形	小菱形 🔸 🔹
小蘑菇	小蘑菇 🍄
小蛋糕	小蛋糕 🍰️
小蜜蜂	小蜜蜂 🐝
小行星	小行星 💫️
小轿车	小轿车 🚗 🚘
小飞机	小飞机 🛩️
小鱼儿	小鱼儿 🐟
小鸡头	小鸡头 🐤
小鸡鸡	小鸡鸡 🐥
小鸭子	小鸭子 🦆
小黑方	小黑方 ▪️
小黑框	小黑框 ⬛
小黑点	小黑点 ⚫
小黑猫	小黑猫 🐈‍⬛
小龙虾	小龙虾 🦞
尚比亚	尚比亚 🇿🇲
就是你	就是你 🫵
就那样	就那样 😌️ 😏️ 😼️
尼德兰	尼德兰 🇳🇱
尼日尔	尼日尔 🇳🇪
尼泊尔	尼泊尔 🇳🇵
居民区	居民区 🏘
居酒屋	居酒屋 🏮
山地车	山地车 🚵‍♂️ 🚵‍♀️
崇拜女	崇拜女 🙇🏻‍♀️
崇拜男	崇拜男 🙇🏻‍♂️
工人女	工人女 👩🏻‍🏭 👷🏻‍♀️
工人男	工人男 👨🏻‍🏭 👷🏻‍♂️
工作犬	工作犬 🐕‍🦺
工具盒	工具盒 🛠️ 🧰
工具箱	工具箱 🧰
工字钉	工字钉 📌️
工程师	工程师 👷🏻 🧑🏻‍💻
左勾拳	左勾拳 🤜🏻
左向拳	左向拳 🤛
左手边	左手边 👈🏻️
左箭头	左箭头 ⬅️ ←
左钩拳	左钩拳 🤜
巧克力	巧克力 🍫
巨石像	巨石像 🗿️
巨蟹座	巨蟹座 ♋
差人女	差人女 👮🏻‍♀️
差人男	差人男 👮🏻‍♂️
巴哈马	巴哈马 🇧🇸
巴士站	巴士站 🚏️
巴拉圭	巴拉圭 🇵🇾
巴拿马	巴拿马 🇵🇦
巴西茶	巴西茶 🧉
巴贝多	巴贝多 🇧🇧
布告牌	布告牌 🪧
布维岛	布维岛 🇧🇻
布隆迪	布隆迪 🇧🇮
布韦岛	布韦岛 🇧🇻
帕斯卡	帕斯卡 ㎩ ㍱ ㎪ ㎫ ㎬
带骨肉	带骨肉 🍖
常青树	常青树 🌲
干得好	干得好 👍
干脆面	干脆面 🦝
平底杯	平底杯 🥃
平底锅	平底锅 🍳
平底鞋	平底鞋 🥿
平方米	平方米 ㎡
幸运草	幸运草 🍀️
幸运饼	幸运饼 🥠
库拉索	库拉索 🇨🇼
废纸箩	废纸箩 🚮️
废纸篓	废纸篓 🗑
康加鼓	康加鼓 🪘
建筑工	建筑工 👷‍♂️ 👷‍♀️
建设中	建设中 🏗️
开心猫	开心猫 😺
开淫趴	开淫趴 🥳
开玩笑	开玩笑 😝
开银趴	开银趴 🥳
开香槟	开香槟 🍾
弓和箭	弓和箭 🏹
录像带	录像带 📼
录像机	录像机 📹️
录影带	录影带 📼
录影机	录影机 📹️
录音带	录音带 📼️
彩虹旗	彩虹旗 🏳️‍🌈
往上指	往上指 👆
往下指	往下指 👇
往右指	往右指 👉
往左指	往左指 👈
律师女	律师女 👩🏻‍⚖️
律师男	律师男 👨🏻‍⚖️
得意猫	得意猫 😼
微生物	微生物 🦠
微笑猫	微笑猫 😸
德古拉	德古拉 🧛‍♂️ 🧛‍♀️
德意志	德意志 🇩🇪
心之舞	心之舞 💞️
心叹号	心叹号 ❣️
心连心	心连心 💞
快递盒	快递盒 📦️
快餐盒	快餐盒 🍱
怀孕女	怀孕女 🤰🏻
怀孕男	怀孕男 🫃🏻
怎么会	怎么会 😢️ 😿️
怎么样	怎么样 😏️
急救车	急救车 🚑
恐惧猫	恐惧猫 🙀
恶魔眼	恶魔眼 🧿
悄悄地	悄悄地 🤫
悠悠球	悠悠球 🪀
惊叹号	惊叹号 ❗ ❕
想一想	想一想 🤔
想不通	想不通 🤔️
意大利	意大利 🇮🇹
感叹号	感叹号 ❗ ❕
感恩节	感恩节 🦃️
慢吞吞	慢吞吞 🦥
慢走女	慢走女 🚶🏻‍♀️
慢走男	慢走男 🚶🏻‍♂️
憋屈女	憋屈女 🙎🏻‍♀️
憋屈男	憋屈男 🙎🏻‍♂️
戏法女	戏法女 🤹🏻‍♀️
戏法男	戏法男 🤹🏻‍♂️
成年人	成年人 🧑🏻
我不听	我不听 🙉
我不看	我不看 🙈
我想想	我想想 🤔
我服了	我服了 🤦‍♂️ 🤦‍♀️
我爱你	我爱你 🤟
我的天	我的天 😱️ 🙀️
我知道	我知道 🙋‍♂️ 🙋‍♀️
戴口罩	戴口罩 😷
戴头巾	戴头巾 👳‍♂️ 👳‍♀️
房屋群	房屋群 🏘
所以呢	所以呢 🤷🏻
手拉手	手拉手 🧑‍🤝‍🧑
手拿包	手拿包 👝
手推车	手推车 🛒
手提包	手提包 👜
手球女	手球女 🤾🏻‍♀️
手球男	手球男 🤾🏻‍♂️
手电筒	手电筒 🔦
手风琴	手风琴 🪗
扑克牌	扑克牌 🎴
打印机	打印机 🖨
打呵欠	打呵欠 🥱
打哈欠	打哈欠 🥱
打响指	打响指 🫰
打喷嚏	打喷嚏 🤧
打坐女	打坐女 🧘🏻‍♀️
打坐男	打坐男 🧘🏻‍♂️
打对钩	打对钩 ☑️
打手球	打手球 🤾‍♂️ 🤾‍♀️
打扑克	打扑克 🃏️
打招呼	打招呼 🙋🏻
打板球	打板球 🏏️
打死你	打死你 👊🏻️
打水战	打水战 🔫️
打游戏	打游戏 🎮️
打滚儿	打滚儿 🤣
打球女	打球女 ⛹🏻‍♀️
打球男	打球男 ⛹🏻‍♂️
打电话	打电话 🤙
打疫苗	打疫苗 💉️
打瞌睡	打瞌睡 😪
打算盘	打算盘 🧮
打篮球	打篮球 ⛹️‍♂️ ⛹️‍♀️
打给我	打给我 🤙
打麻将	打麻将 🀄️
打麻雀	打麻雀 🀄️
扔垃圾	扔垃圾 🚮
托克劳	托克劳 🇹🇰
扩音器	扩音器 📣️ 📢
扬声器	扬声器 🔈 🔉 🔊
批萨饼	批萨饼 🍕
技工女	技工女 👩🏻‍🔧
技工男	技工男 👨🏻‍🔧
技师女	技师女 👩🏻‍🔧
技师男	技师男 👨🏻‍🔧
技术员	技术员 👨‍💻 👩‍💻
把戏女	把戏女 🤹🏻‍♀️
把戏男	把戏男 🤹🏻‍♂️
投票箱	投票箱 🗳
抛媚眼	抛媚眼 😉
护士女	护士女 👩🏻‍⚕️
护士服	护士服 🥼
护士男	护士男 👨🏻‍⚕️
护目镜	护目镜 🥽
护肤霜	护肤霜 🧴
护身符	护身符 🧿
报纸卷	报纸卷 🗞
抱一抱	抱一抱 🤗️
拉丁文	拉丁文 🔠 🔡
拉便便	拉便便 💩
拉大便	拉大便 💩
拉粑粑	拉粑粑 💩
拍电影	拍电影 🎬
拖拉机	拖拉机 🚜
招呼女	招呼女 🙋🏻‍♀️
招呼男	招呼男 🙋🏻‍♂️
招手女	招手女 🙋🏻‍♀️
招手男	招手男 🙋🏻‍♂️
拼图块	拼图块 🧩
拼块儿	拼块儿 🧩
指北针	指北针 🧭
指南针	指南针 🧭
指甲油	指甲油 💅
指着你	指着你 🫵
按摩女	按摩女 💆🏻‍♀️
按摩师	按摩师 💆🏻
按摩男	按摩男 💆🏻‍♂️
捂嘴巴	捂嘴巴 🤭 🙊
捂嘴笑	捂嘴笑 🤭
捂耳朵	捂耳朵 🙉
捏手指	捏手指 🤌
捕鼠器	捕鼠器 🪤
探长女	探长女 🕵🏻‍♀️
探长男	探长男 🕵🏻‍♂️
提款机	提款机 🏧
提示牌	提示牌 🪧
摄像机	摄像机 🎥 📹
摄录机	摄录机 🎥
摄影机	摄影机 🎥
摄氏度	摄氏度 ℃
摊手女	摊手女 🤷🏻‍♀️
摊手男	摊手男 🤷🏻‍♂️
摩天轮	摩天轮 🎡
摩托艇	摩托艇 🛥
摩托车	摩托车 🏍
摩洛哥	摩洛哥 🇲🇦
摩纳哥	摩纳哥 🇲🇨
摩羯座	摩羯座 ♑
撒哈拉	撒哈拉 🇪🇭
操你妈	操你妈 🤬
操控杆	操控杆 🕹
擤鼻子	擤鼻子 🤧
擤鼻涕	擤鼻涕 🤧
攀岩女	攀岩女 🧗🏻‍♀️
攀岩男	攀岩男 🧗🏻‍♂️
攀岩者	攀岩者 🧗‍♂️ 🧗‍♀️
攀登女	攀登女 🧗🏻‍♀️
攀登男	攀登男 🧗🏻‍♂️
收件匣	收件匣 📥️
收件箱	收件箱 📥
收邮件	收邮件 📥
收音机	收音机 📻
放大镜	放大镜 🔍 🔎
放射性	放射性 ☢️
放射线	放射线 ☢️
放映机	放映机 📽
放风筝	放风筝 🪁
救护车	救护车 🚑
救救我	救救我 🆘
救火车	救火车 🚒
救火队	救火队 🧑🏻‍🚒
救生圈	救生圈 🛟
救生服	救生服 🦺
救生衣	救生衣 🦺
教书女	教书女 👩🏻‍🏫
教书男	教书男 👨🏻‍🏫
教学楼	教学楼 🏫
教师女	教师女 👩🏻‍🏫
教师男	教师男 👨🏻‍🏫
教科书	教科书 📗
文件夹	文件夹 📁 📂
文件柜	文件柜 🗄
文件档	文件档 📃️
文件袋	文件袋 🗂️
斑鸠琴	斑鸠琴 🪕
斯波克	斯波克 🖖
斯诺克	斯诺克 🎱️
新加坡	新加坡 🇸🇬
新娘子	新娘子 👰‍♀️
新娘男	新娘男 👰🏻‍♂️
新干线	新干线 🚄 🚅
新疆瓜	新疆瓜 🍈
新西兰	新西兰 🇳🇿
新邮件	新邮件 📨
新郎女	新郎女 🤵🏻‍♀️
方便袋	方便袋 🛍
方程式	方程式 🏎️
施工中	施工中 🚧
无人岛	无人岛 🏝
无助女	无助女 🙍🏻‍♀️
无助男	无助男 🙍🏻‍♂️
无尾熊	无尾熊 🐨
无所谓	无所谓 😌️ 🤷🏻
无望女	无望女 🙍🏻‍♀️
无望男	无望男 🙍🏻‍♂️
无穷大	无穷大 ♾️
无线电	无线电 📻
无线网	无线网 🛜
无邮件	无邮件 📪️
无障碍	无障碍 ♿️
日本国	日本国 🇯🇵
日记本	日记本 📔 📓 📒
旧房子	旧房子 🏚️
旧钥匙	旧钥匙 🗝
早上好	早上好 🙂️
旱冰鞋	旱冰鞋 🛼
明星女	明星女 👩🏻‍🎤
明星男	明星男 👨🏻‍🎤
星号键	星号键 *️⃣
星星眼	星星眼 🤩
星条旗	星条旗 🇺🇸
显微镜	显微镜 🔬
显示器	显示器 🖥
显示屏	显示屏 🖥
晓不得	晓不得 😲️ 🤷🏻
曲别针	曲别针 📎 🖇
曲棍球	曲棍球 🏑
曳引机	曳引机 🚜️
曼哈顿	曼哈顿 🗽️
月弯弯	月弯弯 🌛️ 🌜️
有邮件	有邮件 📫️
有钱人	有钱人 💰️
服务员	服务员 💁‍♂️ 💁‍♀️
服务犬	服务犬 🐕‍🦺
服务费	服务费 🈂️
服务铃	服务铃 🛎
望远镜	望远镜 🔭
木槿花	木槿花 🌺
未成年	未成年 🔞
未睡醒	未睡醒 😵‍💫
未瞓醒	未瞓醒 😵‍💫
本科生	本科生 👨‍🎓 👩‍🎓
朱古力	朱古力 🍫
机器人	机器人 🤖
机器腿	机器腿 🦿
机器臂	机器臂 🦾
机械腿	机械腿 🦿
机械臂	机械臂 🦾
机长女	机长女 👩🏻‍✈️
机长男	机长男 👨🏻‍✈️
杂技女	杂技女 🤹🏻‍♀️
杂技男	杂技男 🤹🏻‍♂️
杠铃女	杠铃女 🏋🏻‍♀️
杠铃男	杠铃男 🏋🏻‍♂️
条子女	条子女 👮🏻‍♀️
条子男	条子男 👮🏻‍♂️
条形图	条形图 📊
来一根	来一根 🚬
来电了	来电了 📲
来邮件	来邮件 📨️
松口气	松口气 😌
板儿砖	板儿砖 🧱
板儿鞋	板儿鞋 👟
板球拍	板球拍 🏏
板球棒	板球棒 🏏️
果汁盒	果汁盒 🧃
枫树叶	枫树叶 🍁
架子鼔	架子鼔 🥁
柔道女	柔道女 🤼🏻‍♀️
柔道服	柔道服 🥋
柔道男	柔道男 🤼🏻‍♂️
柬埔寨	柬埔寨 🇰🇭
柱形图	柱形图 📊
柱状图	柱状图 📊
标签页	标签页 📑
标语牌	标语牌 🪧
树袋熊	树袋熊 🐨
核子弹	核子弹 ☢️
核子能	核子能 ⚛️
核武器	核武器 ☢️
核辐射	核辐射 ☢️
根西岛	根西岛 🇬🇬
格子旗	格子旗 🏁
格子饼	格子饼 🧇
格恩济	格恩济 🇬🇬
格陵兰	格陵兰 🇬🇱
桌游卡	桌游卡 🎴️
桑拿女	桑拿女 🧖🏻‍♀️
桑拿男	桑拿男 🧖🏻‍♂️
档案夹	档案夹 📁️
档案柜	档案柜 🗄️
档案盒	档案盒 🗃️
档案箱	档案箱 🗃️
档案袋	档案袋 🗂️
梅花鹿	梅花鹿 🦌
梵蒂冈	梵蒂冈 🇻🇦
棍网球	棍网球 🥍
棒棒哒	棒棒哒 👍
棒棒的	棒棒的 👍
棒棒糖	棒棒糖 🍭
棒球帽	棒球帽 🧢
棕榈树	棕榈树 🌴
棕色心	棕色心 🤎
椰子果	椰子果 🥥
椰子树	椰子树 🌴️
橄榄枝	橄榄枝 🕊️
橄榄球	橄榄球 🏈 🏉
橘色心	橘色心 🧡
橘黄色	橘黄色 🟠 🟧
橙色心	橙色心 🧡
欢呼女	欢呼女 🙋🏻‍♀️
欢呼男	欢呼男 🙋🏻‍♂️
欢迎女	欢迎女 🙋🏻‍♀️
欢迎男	欢迎男 🙋🏻‍♂️
歌手女	歌手女 👩🏻‍🎤
歌手男	歌手男 👨🏻‍🎤
歌星女	歌星女 👩🏻‍🎤
歌星男	歌星男 👨🏻‍🎤
歌舞厅	歌舞厅 🪩
歌记号	歌记号 〽️
正三角	正三角 🔺
正方形	正方形 ⬛ ⬜
武术服	武术服 🥋
死定了	死定了 😠️ 😾️
死火山	死火山 🗻️
残疾人	残疾人 🦽
残疾女	残疾女 👩🏻‍🦼 👩🏻‍🦽
残疾男	残疾男 👨🏻‍🦼 👨🏻‍🦽
母女俩	母女俩 👩‍👧
母子俩	母子俩 👩‍👦
比中指	比中指 🖕
比利时	比利时 🇧🇪
比基尼	比基尼 👙
比爱心	比爱心 🫶🏻
比萨饼	比萨饼 🍕
毕业帽	毕业帽 🎓
毛毛虫	毛毛虫 🐛
毛线团	毛线团 🧶
毛线球	毛线球 🧶
民工女	民工女 👷🏻‍♀️
民工男	民工男 👷🏻‍♂️
民警女	民警女 👮🏻‍♀️
民警男	民警男 👮🏻‍♂️
气泡酒	气泡酒 🍾️
水拔子	水拔子 🪠
水族馆	水族馆 🐳️
水晶球	水晶球 🔮
水果刀	水果刀 🔪
水球女	水球女 🤽🏻‍♀️
水球男	水球男 🤽🏻‍♂️
水瓶座	水瓶座 ♒
水管工	水管工 👨‍🔧 👩‍🔧
水蜜桃	水蜜桃 🍑️
水龙头	水龙头 🚰
求你了	求你了 🥺 🙏
求婚戒	求婚戒 💍
求求你	求求你 🥺 🙏
汉堡包	汉堡包 🍔
沐浴乳	沐浴乳 🧴
沐浴露	沐浴露 🧴
沙滩伞	沙滩伞 🏖 ⛱️
没事的	没事的 🤗️
没兴趣	没兴趣 😌️
没听看	没听看 🙉️
没想好	没想好 😕️
没意思	没意思 😞️ 😴️
没有嘴	没有嘴 😶
没眼看	没眼看 🙈️
没睡醒	没睡醒 😵‍💫
没钱了	没钱了 💸️
没门女	没门女 🙅🏻‍♀️
没门男	没门男 🙅🏻‍♂️
没问题	没问题 👌
沮丧女	沮丧女 🙍🏻‍♀️
沮丧男	沮丧男 🙍🏻‍♂️
油画棒	油画棒 🖍️
法兰西	法兰西 🇫🇷
法官女	法官女 👩🏻‍⚖️
法官男	法官男 👨🏻‍⚖️
法师女	法师女 🧙🏻‍♀️
法师男	法师男 🧙🏻‍♂️
法拉利	法拉利 🏎️
法拉费	法拉费 🧆
法蒂玛	法蒂玛 🪬
法轮功	法轮功 ☸️
泛舟女	泛舟女 🚣🏻‍♀️
泛舟男	泛舟男 🚣🏻‍♂️
波斯菊	波斯菊 🌼
波札那	波札那 🇧🇼
波浪号	波浪号 〰️
波浪线	波浪线 〰️
注射器	注射器 💉
泰王国	泰王国 🇹🇭
泰迪熊	泰迪熊 🧸
泽西岛	泽西岛 🇯🇪
洋服女	洋服女 🤵🏻‍♀️
洋服男	洋服男 🤵🏻‍♂️
洗发水	洗发水 🧴
洗发露	洗发露 🧴
洗手间	洗手间 🚻 🚾
洗洁精	洗洁精 🧴
派对脸	派对脸 🥳
流口水	流口水 🤤
流星雨	流星雨 🌠️
流眼泪	流眼泪 😢 😭
流鼻涕	流鼻涕 🤧
浅肤色	浅肤色 🏻
浅蓝心	浅蓝心 🩵
海滩伞	海滩伞 ⛱️
海盗旗	海盗旗 🏴‍☠️
海绵擦	海绵擦 🧽
海贼旗	海贼旗 🏴‍☠️
涂指甲	涂指甲 💅🏻️
消防员	消防员 👨‍🚒 👩‍🚒
消防车	消防车 🚒
淡蓝心	淡蓝心 🩵
深肤色	深肤色 🏿
清真寺	清真寺 🕌
渡渡鸟	渡渡鸟 🦤
温度计	温度计 🌡
游乐园	游乐园 🎠
游乐场	游乐场 🛝
游戏机	游戏机 🎮️
游戏牌	游戏牌 🎴️
游泳圈	游泳圈 🛟
游泳女	游泳女 🏊🏻‍♀️
游泳男	游泳男 🏊🏻‍♂️
游泳者	游泳者 🏊‍♂️ 🏊‍♀️
游泳镜	游泳镜 🥽
溜冰鞋	溜冰鞋 ⛸
溜溜球	溜溜球 🪀
滋水枪	滋水枪 🔫
滑旱冰	滑旱冰 🛼
滑板车	滑板车 🛴
滑滑梯	滑滑梯 🛝
滑雪板	滑雪板 🏂
滑雪橇	滑雪橇 🎿
滑雪靴	滑雪靴 🎿️
滚犊子	滚犊子 😛️
漫步女	漫步女 🚶🏻‍♀️
漫步男	漫步男 🚶🏻‍♂️
漫画家	漫画家 👨‍🎨 👩‍🎨
潜水镜	潜水镜 🤿 🥽
澳门元	澳门元 MOP$
澳门币	澳门币 MOP$
火烈鸟	火烈鸟 🦩
火警女	火警女 👩🏻‍🚒
火警男	火警男 👨🏻‍🚒
火车头	火车头 🚂️ 🚆️
火车站	火车站 🚉
火车箱	火车箱 🚆️
灭火器	灭火器 🧯
灭火队	灭火队 🧑🏻‍🚒
灯神女	灯神女 🧞‍♀️
灯神男	灯神男 🧞‍♂️
灯笼椒	灯笼椒 🫑
灰老鼠	灰老鼠 🐀️
灰色心	灰色心 🩶
烂房子	烂房子 🏚️
烂玩意	烂玩意 😒️
烤地瓜	烤地瓜 🍠
烤甘薯	烤甘薯 🍠
烤番薯	烤番薯 🍠
烤红薯	烤红薯 🍠
烤薄饼	烤薄饼 🍕️
烤鸡腿	烤鸡腿 🍖️
烦死了	烦死了 😡
烦死人	烦死人 😡
烦死啦	烦死啦 😡
热带鱼	热带鱼 🐠
热恋中	热恋中 💑🏻️
热死了	热死了 🥵
煎鸡蛋	煎鸡蛋 🍳️
照相机	照相机 📷
熊猫人	熊猫人 🐼
熊猫头	熊猫头 🐼
熊猫脸	熊猫脸 🐼
燕尾服	燕尾服 🤵‍♂️
爆炸头	爆炸头 🤯
爆炸脑	爆炸脑 🤯
爆米花	爆米花 🍿
爬梯子	爬梯子 🪜
爬泳女	爬泳女 🏊🏻‍♀️
爬泳男	爬泳男 🏊🏻‍♂️
爱尔兰	爱尔兰 🇮🇪
父女俩	父女俩 👨‍👧
父子俩	父子俩 👨‍👦
牙买加	牙买加 🇯🇲
牛仔帽	牛仔帽 🤠
牛仔裤	牛仔裤 👖
牛奶杯	牛奶杯 🥛
牛油果	牛油果 🥑
牡羊座	牡羊座 ♈️
特别酷	特别酷 🆒
状师女	状师女 👩🏻‍⚖️
状师男	状师男 👨🏻‍⚖️
犹太教	犹太教 ✡️
狐狸偷	狐狸偷 🦊
狐狸脸	狐狸脸 🦊
狗日的	狗日的 🤬
狗杂种	狗杂种 🤬
独木舟	独木舟 🛶
独角兽	独角兽 🦄
狮子头	狮子头 🦁
狮子座	狮子座 ♌
狮子脸	狮子脸 🦁
猕猴桃	猕猴桃 🥝
猛摇头	猛摇头 🫨
猛犸象	猛犸象 🦣
猛玛象	猛玛象 🦣
猪头三	猪头三 🐷️
猪鼻子	猪鼻子 🐽
猫头鹰	猫头鹰 🦉
玉蜀黍	玉蜀黍 🌽️
王冠女	王冠女 🤴🏻
王冠男	王冠男 👸🏻️
玛黛茶	玛黛茶 🧉
玩具枪	玩具枪 🔫
玩具熊	玩具熊 🧸
玩手球	玩手球 🤾‍♂️ 🤾‍♀️
玩水球	玩水球 🤽‍♂️ 🤽‍♀️
玩游戏	玩游戏 🎮️
玩篮球	玩篮球 ⛹️‍♂️ ⛹️‍♀️
玫瑰花	玫瑰花 🌹
玻璃杯	玻璃杯 🥃
玻璃瓶	玻璃瓶 🫙
玻璃罐	玻璃罐 🫙
玻璃镜	玻璃镜 🪞
珊瑚礁	珊瑚礁 🪸
班主住	班主住 🧑🏻‍🏫
班卓琴	班卓琴 🪕
球员女	球员女 ⛹🏻‍♀️
球员男	球员男 ⛹🏻‍♂️
球门网	球门网 🥅
理发女	理发女 💇🏻‍♀️
理发店	理发店 💈
理发男	理发男 💇🏻‍♂️
理头发	理头发 💇‍♂️ 💇‍♀️
瑜伽女	瑜伽女 🧘‍♀️
瑜伽男	瑜伽男 🧘‍♂️
瑞思拜	瑞思拜 🫡
瓜皮帽	瓜皮帽 👲
甘比亚	甘比亚 🇬🇲
甜甜圈	甜甜圈 🍩
生化品	生化品 ☣️
生气猫	生气猫 😾
田径女	田径女 🏃🏻‍♀️
田径男	田径男 🏃🏻‍♂️
电动车	电动车 🛵
电单车	电单车 🏍️ 🛵
电吉他	电吉他 🎸
电影院	电影院 🎦
电插头	电插头 🔌
电摩托	电摩托 🛵
电灯泡	电灯泡 💡
电脑包	电脑包 💼️
电视塔	电视塔 🗼️
电视机	电视机 📺
电话亭	电话亭 ➿️
电话机	电话机 ☎️
电话筒	电话筒 📞
电话线	电话线 ➿️
电量低	电量低 🪫
男丧尸	男丧尸 🧟‍♂️
男人鱼	男人鱼 🧜‍♂️
男侦探	男侦探 🕵️‍♂️
男僵尸	男僵尸 🧟‍♂️
男医生	男医生 👨‍⚕️
男卫兵	男卫兵 💂‍♂️
男卫士	男卫士 💂‍♂️
男厕所	男厕所 🚹
男厨师	男厨师 👨‍🍳
男反派	男反派 🦹‍♂️
男坏蛋	男坏蛋 🦹‍♂️
男大夫	男大夫 👨‍⚕️
男学生	男学生 👨‍🎓
男工人	男工人 👷‍♂️
男技工	男技工 👨‍🔧
男教师	男教师 👨‍🏫
男新娘	男新娘 👰‍♂️
男歌手	男歌手 👨‍🎤
男法官	男法官 👨‍⚖️
男法师	男法师 🧙‍♂️
男灯神	男灯神 🧞‍♂️
男电工	男电工 👨‍🔧
男画家	男画家 👨‍🎨
男白领	男白领 👨‍💼
男码农	男码农 👨‍💻
男码畜	男码畜 👨‍💻
男精灵	男精灵 🧝‍♂️
男老师	男老师 👨‍🏫
男职员	男职员 👨‍💼
男衬衫	男衬衫 👕
男警官	男警官 👮‍♂️
男警察	男警察 👮‍♂️
男超人	男超人 🦸‍♂️
画家女	画家女 👩🏻‍🎨
画家男	画家男 👨🏻‍🎨
留尼旺	留尼旺 🇷🇪
留尼汪	留尼汪 🇷🇪
略略略	略略略 😛 😜 😝
番茄酱	番茄酱 🥫
病原体	病原体 🦠
登山者	登山者 🧗‍♂️ 🧗‍♀️
登山靴	登山靴 🥾
登山鞋	登山鞋 🥾
白发女	白发女 👩‍🦳
白发男	白发男 👨‍🦳
白叹号	白叹号 ❕
白大褂	白大褂 🥼
白天鹅	白天鹅 🦢
白头发	白头发 🧑🏻‍🦳
白手杖	白手杖 🦯
白炽灯	白炽灯 💡
白眼儿	白眼儿 🙄
白罗斯	白罗斯 🇧🇾
白羊座	白羊座 ♈
白色心	白色心 🤍
白问号	白问号 ❔
白领女	白领女 👩🏻‍💼
白领男	白领男 👨🏻‍💼
百分比	百分比 ㌫
百合花	百合花 ⚜️
百吉圈	百吉圈 🥯
百吉饼	百吉饼 🥯
百慕大	百慕大 🇧🇲
百慕达	百慕达 🇧🇲
皮卡车	皮卡车 🛻
皮纳塔	皮纳塔 🪅
皮老虎	皮老虎 🪠
皮芽子	皮芽子 🧅
皱眉女	皱眉女 🙍🏻‍♀️
皱眉男	皱眉男 🙍🏻‍♂️
盈凸月	盈凸月 🌔
盖亚那	盖亚那 🇬🇾
盘腿女	盘腿女 🧘🏻‍♀️
盘腿男	盘腿男 🧘🏻‍♂️
盥洗室	盥洗室 🚻 🚾
盲人女	盲人女 👩🏻‍🦯
盲人男	盲人男 👨🏻‍🦯
直升机	直升机 🚁
直饮水	直饮水 🚰
相似于	相似于 ≅
省略号	省略号 ……
省省吧	省省吧 🙄️
看不懂	看不懂 😵‍💫 😵️
看不见	看不见 🙈
看守女	看守女 💂🏻‍♀️
看守男	看守男 💂🏻‍♂️
真好女	真好女 🙆🏻‍♀️
真好玩	真好玩 😆️
真好男	真好男 🙆🏻‍♂️
真的吗	真的吗 😓️ 😳️
眯眼笑	眯眼笑 😆
眼镜蛇	眼镜蛇 𓆗
着火了	着火了 🔥
睇唔明	睇唔明 😵‍💫
睡着了	睡着了 😴 💤
睡睰睰	睡睰睰 💤️
瞎子女	瞎子女 👩🏻‍🦯
瞎子男	瞎子男 👨🏻‍🦯
知道了	知道了 😐️
研究员	研究员 🧑🏻‍🔬
破玩意	破玩意 😒️
碗豆荚	碗豆荚 🫛
碧蓝心	碧蓝心 🩵
磁悬浮	磁悬浮 🚄️
磕头女	磕头女 🙇🏻‍♀️
磕头男	磕头男 🙇🏻‍♂️
礼品盒	礼品盒 🎁
礼宾花	礼宾花 🎉
礼拜室	礼拜室 🛐
礼物盒	礼物盒 🎁
神探女	神探女 🕵🏻‍♀️
神探男	神探男 🕵🏻‍♂️
秀肌肉	秀肌肉 💪
私家车	私家车 🚗 🚘
秃头女	秃头女 👩🏻‍🦲
秃头男	秃头男 👨🏻‍🦲
种地女	种地女 👩🏻‍🌾
种地男	种地男 👨🏻‍🌾
种田女	种田女 👩🏻‍🌾
种田男	种田男 👨🏻‍🌾
科威特	科威特 🇰🇼
科威科	科威科 🇰🇼
科学家	科学家 👨‍🔬 👩‍🔬
科摩罗	科摩罗 🇰🇲
科科斯	科科斯 🇨🇨
科索沃	科索沃 🇽🇰
程序员	程序员 👨‍💻 👩‍💻
穆斯林	穆斯林 🧕
空手道	空手道 🥋
空电池	空电池 🪫
空鸟巢	空鸟巢 🪹
突尼斯	突尼斯 🇹🇳
立定女	立定女 🧍🏻‍♀️
立定男	立定男 🧍🏻‍♂️
立方米	立方米 m³
立陶宛	立陶宛 🇱🇹
竖中指	竖中指 🖕
站立女	站立女 🧍🏻‍♀️
站立男	站立男 🧍🏻‍♂️
站立者	站立者 🧍‍♂️ 🧍‍♀️
竞技场	竞技场 🏟️
笑一个	笑一个 😬️
笑哭了	笑哭了 🤣 😂
笔记本	笔记本 📔 📓 📒
笔记簿	笔记簿 📓️ 📔️
第一卷	第一卷 📕
第一名	第一名 🥇
第三卷	第三卷 📘
第三名	第三名 🥉
第二卷	第二卷 📗
第二名	第二名 🥈
第四卷	第四卷 📙
等一会	等一会 ☝🏻️
等于号	等于号 🟰
等价于	等价于 ⇔ ≡ ↔
答对了	答对了 ✅
答错了	答错了 ❌ ❎
签语饼	签语饼 🥠
简直了	简直了 😱️ 🙀️
粉红心	粉红心 🩷
粉色心	粉色心 🩷
粉蓝旗	粉蓝旗 🏳️‍⚧️
粗等号	粗等号 🟰
精灵女	精灵女 🧝🏻‍♀️
精灵族	精灵族 🧝‍♂️ 🧝‍♀️
精灵男	精灵男 🧝🏻‍♂️
糖果球	糖果球 🎊
糖葫芦	糖葫芦 🍡️
糯米团	糯米团 🍡
索引卡	索引卡 📇️
索马里	索马里 🇸🇴
紫色心	紫色心 💜
纠结女	纠结女 🤦🏻‍♀️
纠结男	纠结男 🤦🏻‍♂️
红发女	红发女 👩‍🦰
红发男	红发男 👨‍🦰 👨‍🦱
红头发	红头发 👩‍🦰 🦰
红灯笼	红灯笼 🏮
红猩猩	红猩猩 🦧
红玫瑰	红玫瑰 🌹
红绿灯	红绿灯 🚥 🚦
红苹果	红苹果 🍎
红萝卜	红萝卜 🥕
红辣椒	红辣椒 🌶
约等于	约等于 ≈ ≅
纸箱子	纸箱子 📦
纽西兰	纽西兰 🇳🇿
线圈本	线圈本 🗒
终点旗	终点旗 🏁
经纬线	经纬线 🌐
络腮胡	络腮胡 🧔
绣花针	绣花针 🪡
维德角	维德角 🇨🇻
绿色心	绿色心 💚
绿苹果	绿苹果 🍏
绿菜花	绿菜花 🥦
缝纫针	缝纫针 🪡
缝衣针	缝衣针 🪡
缠头女	缠头女 👳🏾‍♀️
缠头男	缠头男 👳🏾‍♂️
缠绷带	缠绷带 🤕
缺心眼	缺心眼 🤪 (´◑д◐｀)
网球鞋	网球鞋 👟
羊皮纸	羊皮纸 📜️
美人鱼	美人鱼 🧜‍♀️
美利坚	美利坚 🇺🇸
美洲豹	美洲豹 🐆
美洲驼	美洲驼 🦙
美男鱼	美男鱼 🧜‍♂️
羽毛球	羽毛球 🏸
翅膀钱	翅膀钱 💸
翻白眼	翻白眼 🙄
翻筋斗	翻筋斗 🤸‍♂️ 🤸‍♀️
翻跟头	翻跟头 🤸‍♂️ 🤸‍♀️
老太太	老太太 👵
老头儿	老头儿 👴
老女人	老女人 👵🏻️
老奶奶	老奶奶 👵
老师女	老师女 👩🏻‍🏫
老师男	老师男 👨🏻‍🏫
老游戏	老游戏 👾️
老火车	老火车 🚂️
老爷爷	老爷爷 👴
老男人	老男人 👴🏻️
老花镜	老花镜 👓️
老虎头	老虎头 🐯
老虎机	老虎机 🎰
老虎脸	老虎脸 🐯
老钥匙	老钥匙 🗝
老鼠头	老鼠头 🐭
老鼠夹	老鼠夹 🪤
老鼠脸	老鼠脸 🐭
耳聋女	耳聋女 🧏🏻‍♀️
耳聋男	耳聋男 🧏🏻‍♂️
聋哑人	聋哑人 🧏🏻
聋哑女	聋哑女 🧏🏻‍♀️
聋哑男	聋哑男 🧏🏻‍♂️
聋子女	聋子女 🧏🏻‍♀️
聋子男	聋子男 🧏🏻‍♂️
职员女	职员女 👩🏻‍💼
职员男	职员男 👨🏻‍💼
联合国	联合国 🇺🇳
肉丸子	肉丸子 🧆
肏你妈	肏你妈 🤬
肩并肩	肩并肩 🧑🏻‍🤝‍🧑🏻
肯尼亚	肯尼亚 🇰🇪
肱二头	肱二头 💪
胡子女	胡子女 🧔‍♀️
胡子男	胡子男 🧔🏻‍♂️
胡萝卜	胡萝卜 🥕
胡须女	胡须女 🧔🏻‍♀️
胡须男	胡须男 🧔🏻‍♂️
脑爆炸	脑爆炸 🤯
脚丫子	脚丫子 🦶
脚踏车	脚踏车 🚲
脸发烧	脸发烧 🥵
自来水	自来水 🚰️
自由泳	自由泳 🏊🏻
自行车	自行车 🚲
舰长女	舰长女 👩🏻‍✈️
舰长男	舰长男 👨🏻‍✈️
船长女	船长女 👩🏻‍✈️
船长男	船长男 👨🏻‍✈️
色士风	色士风 🎷️
艺人女	艺人女 👩🏻‍🎨
艺人男	艺人男 👨🏻‍🎨
艺术家	艺术家 👨‍🎨 👩‍🎨
芙蓉花	芙蓉花 🌺
芭蕾舞	芭蕾舞 🩰
芭蕾鞋	芭蕾鞋 🩰
花园房	花园房 🏡️
花大姐	花大姐 🐞
花栗鼠	花栗鼠 🐿
花椰菜	花椰菜 🥦
花痴猫	花痴猫 😻
苏利南	苏利南 🇸🇷
苏格兰	苏格兰 🏴󠁧󠁢󠁳󠁣󠁴󠁿
苏里南	苏里南 🇸🇷
英格兰	英格兰 🏴󠁧󠁢󠁥󠁮󠁧󠁿
英联邦	英联邦 🇬🇧
英雄女	英雄女 🦸🏻‍♀️
英雄男	英雄男 🦸🏻‍♂️
茅草屋	茅草屋 🛖
茅草房	茅草房 🛖
草泥马	草泥马 🦙
荷包蛋	荷包蛋 🍳️
莱索托	莱索托 🇱🇸
莲花坐	莲花坐 🧘‍♂️ 🧘‍♀️
菜篮子	菜篮子 🧺
菜青虫	菜青虫 🐛️
菲律宾	菲律宾 🇵🇭
萨克斯	萨克斯 🎷
萨摩亚	萨摩亚 🇼🇸
落叶树	落叶树 🌳
落花生	落花生 🥜
葡萄牙	葡萄牙 🇵🇹
葡萄酒	葡萄酒 🍷
蒙古包	蒙古包 🛖
蒙古国	蒙古国 🇲🇳
蒙哲腊	蒙哲腊 🇲🇸
蒙眼睛	蒙眼睛 🙈
蒲隆地	蒲隆地 🇧🇮
蒸桑拿	蒸桑拿 🧖‍♂️ 🧖‍♀️
蒸汽船	蒸汽船 🚢️
蒸馏器	蒸馏器 ⚗️
蒸馏瓶	蒸馏瓶 ⚗️
蓄电池	蓄电池 🔋
蓝眼睛	蓝眼睛 🧿
蓝色心	蓝色心 💙 🩵
蔬菜球	蔬菜球 🧆
蕃茄酱	蕃茄酱 🥫
薄煎饼	薄煎饼 🥞
虚线脸	虚线脸 🫥
蛇夫座	蛇夫座 ⛎
蛋奶冻	蛋奶冻 🍮️
蛋奶糕	蛋奶糕 🍮
蛾眉月	蛾眉月 🌒 🌘
蜘蛛网	蜘蛛网 🕸
蝴蝶结	蝴蝶结 🎀
蝴蝶饼	蝴蝶饼 🥨
螺丝刀	螺丝刀 🪛
蟹老板	蟹老板 🦀
行人女	行人女 🚶🏻‍♀️
行人男	行人男 🚶🏻‍♂️
行李箱	行李箱 🧳
行走女	行走女 🚶🏻‍♀️
行走男	行走男 🚶🏻‍♂️
袋棍球	袋棍球 🥍
裹头女	裹头女 👳🏾‍♀️
裹头男	裹头男 👳🏾‍♂️
西兰花	西兰花 🥦
西服女	西服女 🤵🏻‍♀️
西服男	西服男 🤵🏻‍♂️
西班牙	西班牙 🇪🇸
西红柿	西红柿 🍅
西装女	西装女 🤵🏻‍♀️
西装男	西装男 🤵🏻‍♂️
要哭了	要哭了 🥹
观赏鱼	观赏鱼 🐠️
警察女	警察女 👮🏻‍♀️
警察男	警察男 👮🏻‍♂️
警示牌	警示牌 🪧
警车灯	警车灯 🚨
计时器	计时器 ⏱
计程车	计程车 🚕️
计算机	计算机 🖥
订婚戒	订婚戒 💍
认不得	认不得 😲️ 🤷🏻
认输了	认输了 🏳
记事本	记事本 📔 📓 📒
讲大话	讲大话 🤥
讲话者	讲话者 🗣
许可证	许可证 🎟️
识别卡	识别卡 📛️
说不出	说不出 🙊️
说脏话	说脏话 🤬
读书人	读书人 🤓️
课堂女	课堂女 👩🏻‍🏫
课堂男	课堂男 👨🏻‍🏫
课室女	课室女 👩🏻‍🏫
课室男	课室男 👨🏻‍🏫
谁知道	谁知道 🤷‍♂️ 🤷‍♀️
调味品	调味品 🧂
调色板	调色板 🎨
调色盘	调色盘 🎨
谈恋爱	谈恋爱 👩‍❤️‍👨
谢顶女	谢顶女 👩🏻‍🦲
谢顶男	谢顶男 👨🏻‍🦲
豌豆荚	豌豆荚 🫛
贝里斯	贝里斯 🇧🇿
购物袋	购物袋 🛍
购物车	购物车 🛒
贵宾犬	贵宾犬 🐩
贵宾狗	贵宾狗 🐩️
贷记卡	贷记卡 💳
赌博机	赌博机 🎰️
赖索托	赖索托 🇱🇸
赛艇女	赛艇女 🚣🏻‍♀️
赛艇男	赛艇男 🚣🏻‍♂️
赞比亚	赞比亚 🇿🇲
起始符	起始符 〽️
起泡酒	起泡酒 🍾️
起重机	起重机 🏗
超人女	超人女 🦸🏻‍♀️
超人男	超人男 🦸🏻‍♂️
超级辣	超级辣 🥵
越野车	越野车 🚙
足尖鞋	足尖鞋 🩰
足球场	足球场 🏟
跆拳道	跆拳道 🥋
跑步者	跑步者 🏃‍♂️ 🏃‍♀️
跑男女	跑男女 🏃🏻‍♀️
跑男男	跑男男 🏃🏻‍♂️
跨性别	跨性别 ⚧ 🏳️‍⚧️
跪下女	跪下女 🧎🏻‍♀️
跪下男	跪下男 🧎🏻‍♂️
跪拜女	跪拜女 🙇🏻‍♀️ 🧎🏻‍♀️
跪拜男	跪拜男 🙇🏻‍♂️ 🧎🏻‍♂️
踏板车	踏板车 🛴
蹙眉女	蹙眉女 🙍🏻‍♀️
蹙眉男	蹙眉男 🙍🏻‍♂️
身份证	身份证 🪪 🆔
身体乳	身体乳 🧴
身分证	身分证 🆔️ 🪪
身孕女	身孕女 🤰🏻
身孕男	身孕男 🫃🏻
车厘子	车厘子 🍒️
车来了	车来了 🚘️
车轮子	车轮子 🛞
车轱辘	车轱辘 🛞
轧路机	轧路机 🚜️
轨迹球	轨迹球 🖲
轨道车	轨道车 🚃
轮滑鞋	轮滑鞋 🛼
辛巴威	辛巴威 🇿🇼
辣死了	辣死了 🥵
达玛尔	达玛尔 🫔
过山车	过山车 🎢
运动㡌	运动㡌 🧢
运动场	运动场 🏟️
运动服	运动服 🎽
运动鞋	运动鞋 👟
近视眼	近视眼 👓
还原号	还原号 ♮
这边女	这边女 💁🏻‍♀️
这边男	这边男 💁🏻‍♂️
远大于	远大于 ≫
远小于	远小于 ≪
连体衣	连体衣 🩱
连衣裙	连衣裙 👗
迪斯科	迪斯科 🪩
追日花	追日花 🌻
送货车	送货车 🚚
逆时针	逆时针 🔄
逐日花	逐日花 🌻
逗你玩	逗你玩 😜️
通心粉	通心粉 🍝️
通话中	通话中 🤙🏻
通通乐	通通乐 🪠
遮阳伞	遮阳伞 ⛱️
邮便所	邮便所 🏣️
邮政局	邮政局 🏤️
邱比特	邱比特 💘️
郁金香	郁金香 🌷
酢浆草	酢浆草 ☘️
重升号	重升号 𝄪
重金属	重金属 👨‍🎤 👩‍🎤
量体温	量体温 🤒
金发女	金发女 👱 👱‍♀️
金发男	金发男 👱‍♂️
金属礼	金属礼 🤘
金毛犬	金毛犬 🦮
金牛座	金牛座 ♉
金龟子	金龟子 🪲
钓鱼竿	钓鱼竿 🎣
钢琴键	钢琴键 🎹
钢镚儿	钢镚儿 🪙
钱丢了	钱丢了 💸️
钱眼儿	钱眼儿 🤑
钱飞了	钱飞了 💸️
铁道车	铁道车 🚃️
铁链子	铁链子 ⛓️
银河系	银河系 🌌
银行卡	银行卡 💳
锡克教	锡克教 🪯
镜面球	镜面球 🪩
长方形	长方形 ⎕
长明灯	长明灯 🪔
长筒靴	长筒靴 👢️
长货车	长货车 🚛️
长面包	长面包 🥖
长颈鹿	长颈鹿 🦒
长鼻子	长鼻子 🤥
门卫女	门卫女 💂🏻‍♀️
门卫男	门卫男 💂🏻‍♂️
闪光灯	闪光灯 📸
问叹号	问叹号 ⁉️
间谍女	间谍女 🕵🏻‍♀️
间谍男	间谍男 🕵🏻‍♂️
防护镜	防护镜 🥽
阴暗面	阴暗面 🌚️
阿富汗	阿富汗 🇦🇫
阿拉丁	阿拉丁 🧞‍♂️ 🧞‍♀️
阿拉伯	阿拉伯 🇦🇪
阿根廷	阿根廷 🇦🇷
阿森松	阿森松 🇦🇨
阿联酋	阿联酋 🇦🇪
阿鲁巴	阿鲁巴 🇦🇼
降落伞	降落伞 🪂
雪花片	雪花片 ❄️
零钱包	零钱包 👛
雷阵雨	雷阵雨 ⛈️
雾蒙蒙	雾蒙蒙 🌁
霜淇淋	霜淇淋 🍦️
露齿笑	露齿笑 😃
霸王龙	霸王龙 🦖
青橄榄	青橄榄 🫒
青花菜	青花菜 🥦
青苹果	青苹果 🍏
青蛙头	青蛙头 🐸
青蛙脸	青蛙脸 🐸
静坐女	静坐女 🧘🏻‍♀️
静坐男	静坐男 🧘🏻‍♂️
非常棒	非常棒 👍
面包圈	面包圈 🥯
面包车	面包车 🚐
鞠躬女	鞠躬女 🙇🏻‍♀️
鞠躬男	鞠躬男 🙇🏻‍♂️
顺时针	顺时针 🔃
风信子	风信子 🪻
风吹拂	风吹拂 🌬
风景区	风景区 🏞️
飞旋镖	飞旋镖 🪃
飞行员	飞行员 👨‍✈️ 👩‍✈️
饮水处	饮水处 🚰
饮用水	饮用水 🚰
马其顿	马其顿 🇲🇰
马尔他	马尔他 🇲🇹
马恩岛	马恩岛 🇮🇲
马戏团	马戏团 🎪
马拉松	马拉松 🏃‍♂️ 🏃‍♀️
马拉烕	马拉烕 🇲🇼
马拉维	马拉维 🇲🇼
马桶吸	马桶吸 🪠
马桶塞	马桶塞 🪠
马约特	马约特 🇾🇹
马耳他	马耳他 🇲🇹
马铃薯	马铃薯 🥔
马黛茶	马黛茶 🧉
驼鹿头	驼鹿头 🫎
驼鹿脸	驼鹿脸 🫎
驾雪橇	驾雪橇 🛷
骑单车	骑单车 🚴‍♂️ 🚴‍♀️
骑行女	骑行女 🚴🏻‍♀️
骑行男	骑行男 🚴🏻‍♂️
骑车女	骑车女 🚴🏻‍♀️
骑车男	骑车男 🚴🏻‍♂️
骗人布	骗人布 🤥
骗你的	骗你的 😜️
骨灰瓶	骨灰瓶 ⚱️
骨灰盒	骨灰盒 ⚱️
骨灰缸	骨灰缸 ⚱️
骷髅头	骷髅头 💀 ☠️
高亮度	高亮度 🔆
高压电	高压电 ⚡
高尔夫	高尔夫 🏌️‍♂️ 🏌️‍♀️ ⛳
高脚杯	高脚杯 🍷️
高跟儿	高跟儿 👠
高跟靴	高跟靴 👢
高跟鞋	高跟鞋 👠
高速路	高速路 🛣️
高音量	高音量 🔊
魔头女	魔头女 🦹🏻‍♀️
魔头男	魔头男 🦹🏻‍♂️
魔术师	魔术师 🧙‍♂️ 🧙‍♀️
魔术帽	魔术帽 🎩️
魔法女	魔法女 🧙🏻‍♀️
魔法师	魔法师 🧙‍♂️ 🧙‍♀️
魔法棒	魔法棒 🪄
魔法男	魔法男 🧙🏻‍♂️
魔法阵	魔法阵 🔯
鲤鱼旗	鲤鱼旗 🎏
鲸鱼座	鲸鱼座 🔯️
鸡尾酒	鸡尾酒 🍸
鸡腿儿	鸡腿儿 🍗
鸡蛋饼	鸡蛋饼 🌮️
鸢尾花	鸢尾花 ⚜️
鸭舌㡌	鸭舌㡌 🧢
鸭舌帽	鸭舌帽 🧢
鹅鹅鹅	鹅鹅鹅 🪿
鹤嘴锄	鹤嘴锄 ⛏️
麒麟鹿	麒麟鹿 🦒
麦克风	麦克风 🎙 🎤
麻烦女	麻烦女 🤦🏻‍♀️
麻烦男	麻烦男 🤦🏻‍♂️
黄丝带	黄丝带 🎗
黄乳油	黄乳油 🧈
黄包车	黄包车 🛺
黄色心	黄色心 💛
黄鼠狼	黄鼠狼 🦡
黎巴嫩	黎巴嫩 🇱🇧
黑猩猩	黑猩猩 🦍
黑白棋	黑白棋 ⚫ ⚪
黑色心	黑色心 🖤
黑色旗	黑色旗 🏴
龙凤胎	龙凤胎 👨‍👩‍👧‍👦
龙卷风	龙卷风 🌪
一二三四	一二三四 🔢
一卷报纸	一卷报纸 🗞️
一只眼睛	一只眼睛 👁
一家三口	一家三口 👨‍👩‍👦 👨‍👩‍👧
一家四口	一家四口 👨‍👩‍👧‍👦 👨‍👩‍👦‍👦 👨‍👩‍👧‍👧
一摞课本	一摞课本 📚️
一杯奶茶	一杯奶茶 🧋
一箭穿心	一箭穿心 💘
一脸不悦	一脸不悦 🙁
一锅食物	一锅食物 🥘 🍲
七星瓢虫	七星瓢虫 🐞
三口之家	三口之家 👨‍👩‍👦 👨‍👩‍👧
上下箭头	上下箭头 ↕️ ↕
上下颠倒	上下颠倒 🙃️
下载邮件	下载邮件 📩️
不丹王国	不丹王国 🇧🇹
不关我事	不关我事 🤷🏻
不准吸烟	不准吸烟 🚭️
不告诉你	不告诉你 😏️
不好意思	不好意思 🙇‍♂️ 🙇‍♀️
不敢相信	不敢相信 🫢
不知道女	不知道女 🤷🏻‍♀️
不知道男	不知道男 🤷🏻‍♂️
世界和平	世界和平 ☮️
世界地图	世界地图 🗺
东京铁塔	东京铁塔 🗼
东萨摩亚	东萨摩亚 🇦🇸
两个女人	两个女人 👭
两个男人	两个男人 👬
两边打开	两边打开 🔛️
个人电脑	个人电脑 💻
中华民国	中华民国 🇹🇼
中国大陆	中国大陆 🇨🇳
中国澳门	中国澳门 🇲🇴
中国香港	中国香港 🇭🇰
中正方形	中正方形 ◼ ◻
中秋佳节	中秋佳节 🎑
中等方块	中等方块 ◼ ◻
中等白方	中等白方 ◻️
中等肤色	中等肤色 🏽
中等音量	中等音量 🔉
中等黑方	中等黑方 ◼️
举起拳头	举起拳头 ✊
举起的手	举起的手 ✋
义大利面	义大利面 🍝️
乌云蔽日	乌云蔽日 ⛅
乌兹别克	乌兹别克 🇺🇿
乌孜别克	乌孜别克 🇺🇿
乒乓球拍	乒乓球拍 🏓
九枝灯台	九枝灯台 🕎️
也就这样	也就这样 😪️
书呆子脸	书呆子脸 🤓
书签标签	书签标签 📑
云中的脸	云中的脸 😶‍🌫️
云霄飞车	云霄飞车 🎢️
五星红旗	五星红旗 🇨🇳
亚塞拜然	亚塞拜然 🇦🇿
亚洲澳洲	亚洲澳洲 🌏
亚美尼亚	亚美尼亚 🇦🇲
交叉箭头	交叉箭头 🔀
亲亲猫脸	亲亲猫脸 😽
亲亲的猫	亲亲的猫 😽
人工智能	人工智能 🤖️
人物剪影	人物剪影 👤
人造卫星	人造卫星 🛰️
以色列国	以色列国 🇮🇱
伊斯兰教	伊斯兰教 ☪️
伪装的脸	伪装的脸 🥸
低头忧伤	低头忧伤 😔
低音谱号	低音谱号 𝄢
你妈死了	你妈死了 🤬
便利商店	便利商店 🏪
保加利亚	保加利亚 🇧🇬
保龄球瓶	保龄球瓶 🎳
信你有鬼	信你有鬼 😒️
信号强度	信号强度 📶
倒挂列车	倒挂列车 🚟️
倒退按钮	倒退按钮 ◀️
倾倒液体	倾倒液体 🫗
停止播放	停止播放 ⏹️
停车按钮	停车按钮 🅿️
像素游戏	像素游戏 👾️
儿童过街	儿童过街 🚸
兄弟姊妹	兄弟姊妹 👫🏻
兄弟姐妹	兄弟姐妹 👫🏻
光头女人	光头女人 👩‍🦲
光头女子	光头女子 👩‍🦲
光头男人	光头男人 👨‍🦲
光头男子	光头男子 👨‍🦲
克利珀顿	克利珀顿 🇨🇵
克罗地亚	克罗地亚 🇭🇷
免费电话	免费电话 ➿️
全莲花坐	全莲花坐 🧘‍♂️ 🧘‍♀️
八分音符	八分音符 ♪
公交车站	公交车站 🚏
公共广播	公共广播 📢
公共汽车	公共汽车 🚌 🚍
共产主义	共产主义 ☭
关闭手机	关闭手机 📴
冒汗焦虑	冒汗焦虑 😰
军用头盔	军用头盔 🪖
农民工女	农民工女 👷🏻‍♀️
农民工男	农民工男 👷🏻‍♂️
冰上溜石	冰上溜石 🥌
出口成脏	出口成脏 🤬
击剑选手	击剑选手 🤺
分析报告	分析报告 📊️
利比亚国	利比亚国 🇱🇾
利比里亚	利比里亚 🇱🇷
前方施工	前方施工 🚧
剪头发女	剪头发女 💇🏻‍♀️
剪头发男	剪头发男 💇🏻‍♂️
勿丢垃圾	勿丢垃圾 🚯
勿扔垃圾	勿扔垃圾 🚯
化学物质	化学物质 🧪
北极熊头	北极熊头 🐻‍❄️
北极熊脸	北极熊脸 🐻‍❄️
北马其顿	北马其顿 🇲🇰
医护人员	医护人员 👨‍⚕️ 👩‍⚕️
医疗标志	医疗标志 ⚕
医疗符号	医疗符号 ⚕
医神权杖	医神权杖 ⚕️
十一点半	十一点半 🕦
十一点钟	十一点钟 🕚
十二点半	十二点半 🕧
十二点钟	十二点钟 🕛
十字头盔	十字头盔 ⛑️
十字路口	十字路口 🚥️ 🚦️
单亲妈妈	单亲妈妈 👩‍👦 👩‍👧 👩‍👧‍👦
单亲家庭	单亲家庭 👨‍👦 👨‍👧 👨‍👧‍👦 👩‍👦 👩‍👧 👩‍👧‍👦
单亲爸爸	单亲爸爸 👨‍👦 👨‍👧 👨‍👧‍👦
单峰骆驼	单峰骆驼 🐪
单曲循环	单曲循环 🔂
单板滑雪	单板滑雪 🏂
单片眼镜	单片眼镜 🧐
单眼偷看	单眼偷看 🫣
单眼吐舌	单眼吐舌 😜
单蛇之杖	单蛇之杖 ⚕
单身母亲	单身母亲 👩‍👦 👩‍👧 👩‍👧‍👦
单身父亲	单身父亲 👨‍👦 👨‍👧 👨‍👧‍👦
单轨电车	单轨电车 🚝️
单轨铁路	单轨铁路 🚝
单选按钮	单选按钮 🔘
博茨瓦纳	博茨瓦纳 🇧🇼
卡塔尔国	卡塔尔国 🇶🇦
卡片相机	卡片相机 📷
卡片索引	卡片索引 📇
卡牌索引	卡牌索引 📇
卫星天线	卫星天线 📡
印度寺庙	印度寺庙 🛕
印度神庙	印度神庙 🛕
危地马拉	危地马拉 🇬🇹
卷发女人	卷发女人 👩‍🦱
卷发女子	卷发女子 👩‍🦱
卷边的纸	卷边的纸 📃
厄利垂亚	厄利垂亚 🇪🇷
厄瓜多尔	厄瓜多尔 🇪🇨
原子符号	原子符号 ⚛️
双剑交叉	双剑交叉 ⚔️
双卷曲环	双卷曲环 ➿
双峰骆驼	双峰骆驼 🐫
双惊叹号	双惊叹号 ‼️
双感叹号	双感叹号 ‼️
双手合十	双手合十 🙏
双手张开	双手张开 👐
双板滑雪	双板滑雪 ⛷️
受伤的心	受伤的心 ❤️‍🩹
古典建筑	古典建筑 🏛
可怜兮兮	可怜兮兮 🥺
台式电脑	台式电脑 🖥
史瓦济兰	史瓦济兰 🇸🇿
右上箭头	右上箭头 ↗️ ↗
右下箭头	右下箭头 ↘️ ↘
叹号问号	叹号问号 ⁉️
吃比萨饼	吃比萨饼 🍕
各种手势	各种手势 👈 👉 ☝ 👆 🖕 👇 ✌ 🤞 🖖 🤘 🤙 🖐 ✋ 👌 👍 👎 ✊ 👊 🤛 🤜 🤚 👋 🤟 ✍ 👏 👐 🤲 🤌 🫱 🫲 🫳 🫴 🫰 🫵 🫶 🫸 🫷
各种扑克	各种扑克 🃏️ ♠ ♥ ♦ ♣ ♤ ♡ ♧ ♢ 🂡 🂱 🃁 🃑 🂢 🂲 🃂 🃒 🂣 🂳 🃃 🃓 🂤 🂴 🃄 🃔 🂥 🂵 🃅 🃕 🂦 🂶 🃆 🃖 🂧 🂷 🃇 🃗 🂨 🂸 🃈 🃘 🂩 🂹 🃉 🃙 🂪 🂺 🃊 🃚 🂫 🂻 🃋 🃛 🂬 🂼 🃌 🃜 🂭 🂽 🃍 🃝 🂮 🂾 🃎 🃞 🂠 🂿 🃟 🃠 🃡 🃢 🃣 🃤 🃥 🃦 🃧 🃨 🃩 🃪 🃫 🃬 🃭 🃮 🃯 🃰 🃱 🃲 🃳 🃴 🃵
各种数字	各种数字 ⓪ ① ② ③ ④ ⑤ ⑥ ⑦ ⑧ ⑨ ⑩ ⑪ ⑫ ⑬ ⑭ ⑮ ⑯ ⑰ ⑱ ⑲ ⑳ ⓿ ❶ ❷ ❸ ❹ ❺ ❻ ❼ ❽ ❾ ❿ ⓫ ⓬ ⓭ ⓮ ⓯ ⓰ ⓱ ⓲ ⓳ ⓴ ⑴ ⑵ ⑶ ⑷ ⑸ ⑹ ⑺ ⑻ ⑼ ⑽ ⑾ ⑿ ⒀ ⒁ ⒂ ⒃ ⒄ ⒅ ⒆ ⒇ ㈠ ㈡ ㈢ ㈣ ㈤ ㈥ ㈦ ㈧ ㈨ ㈩ ㊀ ㊁ ㊂ ㊃ ㊄ ㊅ ㊆ ㊇ ㊈ ㊉ 🈩 🈔 🈪 🉂 🉁
各种日期	各种日期 ㏠ ㏡ ㏢ ㏣ ㏤ ㏥ ㏦ ㏧ ㏨ ㏩ ㏪ ㏫ ㏬ ㏭ ㏮ ㏯ ㏰ ㏱ ㏲ ㏳ ㏴ ㏵ ㏶ ㏷ ㏸ ㏹ ㏺ ㏻ ㏼ ㏽ ㏾
各种月亮	各种月亮 🌑 🌒 🌓 🌔 🌖 🌗 🌘 🌛 🌜
各种月份	各种月份 ㋀ ㋁ ㋂ ㋃ ㋄ ㋅ ㋆ ㋇ ㋈ ㋉ ㋊ ㋋
各种游戏	各种游戏 🎮️ 👾️ 🎰 🎲 🎯 🎳 🪅 🎧 🎤 🎪 🎫 🎟 ♟ 🕹 🖲 🪀
各种象棋	各种象棋 🩠 🩡 🩢 🩣 🩤 🩥 🩦 🩧 🩨 🩩 🩪 🩫 🩬 🩭
合上的锁	合上的锁 🔒
合作愉快	合作愉快 🤝
吉尔吉斯	吉尔吉斯 🇰🇬
吉里巴斯	吉里巴斯 🇰🇮
向上箭头	向上箭头 ⬆️
向下箭头	向下箭头 ⬇️
向右推手	向右推手 🫸
向右的手	向右的手 🫱
向右箭头	向右箭头 ➡️
向左推手	向左推手 🫷
向左的手	向左的手 🫲
向左箭头	向左箭头 ⬅️
含泪笑脸	含泪笑脸 🥲
听不下去	听不下去 😞️
听不见女	听不见女 🧏🏻‍♀️
听不见男	听不见男 🧏🏻‍♂️
听力障碍	听力障碍 🦻
吸血鬼女	吸血鬼女 🧛🏻‍♀️
吸血鬼男	吸血鬼男 🧛🏻‍♂️
呼吸作用	呼吸作用 🫁
和平手势	和平手势 ✌️
和平标志	和平标志 ☮️
和平符号	和平符号 ☮️
和平象征	和平象征 🕊
咬住嘴唇	咬住嘴唇 🫦
咬牙切齿	咬牙切齿 😬
哈哈哈哈	哈哈哈哈 🤣
哈雷彗星	哈雷彗星 ☄️
响铃关闭	响铃关闭 🔕
哥伦比亚	哥伦比亚 🇨🇴
哭泣猫脸	哭泣猫脸 😿
哭泣的猫	哭泣的猫 😿
唔关我事	唔关我事 🤷🏻
唔好意思	唔好意思 🙏🏻️
唯利是图	唯利是图 🤑️
商标符号	商标符号 ™
啥也没说	啥也没说 🙊️
啦啦队女	啦啦队女 👯🏻‍♀️
啦啦队男	啦啦队男 👯🏻‍♂️
喜极而泣	喜极而泣 😹
喜笑颜开	喜笑颜开 🥰
喷水的鲸	喷水的鲸 🐳
噘嘴猫脸	噘嘴猫脸 😾
噘嘴的人	噘嘴的人 🙎‍♂️ 🙎‍♀️
噘嘴的猫	噘嘴的猫 😾
四分音符	四分音符 ♩
四口之家	四口之家 👨‍👩‍👧‍👦 👨‍👩‍👦‍👦 👨‍👩‍👧‍👧
回到开始	回到开始 🔚️
回到顶部	回到顶部 🔝️
固定电话	固定电话 ☎️
国家公园	国家公园 🏞
国际象棋	国际象棋 ♟
圣卢西亚	圣卢西亚 🇱🇨
圣巴瑟米	圣巴瑟米 🇧🇱
圣诞夫人	圣诞夫人 🤶
圣诞奶奶	圣诞奶奶 🤶
圣诞老人	圣诞老人 🎅
圣赫伦那	圣赫伦那 🇸🇭
圣赫勒拿	圣赫勒拿 🇸🇭
圣露西亚	圣露西亚 🇱🇨
圣马利诺	圣马利诺 🇸🇲
圣马力诺	圣马力诺 🇸🇲
地下铁路	地下铁路 🚇
坎达符号	坎达符号 🪯
坠入爱河	坠入爱河 🥰
坦尚尼亚	坦尚尼亚 🇹🇿
坦桑尼亚	坦桑尼亚 🇹🇿
垂涎三尺	垂涎三尺 🤤
垃圾入篓	垃圾入篓 🚮
城市景观	城市景观 🏙
城市风光	城市风光 🏙
基里巴斯	基里巴斯 🇰🇮
堵上耳朵	堵上耳朵 🙉
堵住耳朵	堵住耳朵 🙉
堵着耳朵	堵着耳朵 🙉
塞内加尔	塞内加尔 🇸🇳
塞尔维亚	塞尔维亚 🇷🇸
塞拉利昂	塞拉利昂 🇸🇱
塞浦路斯	塞浦路斯 🇨🇾
墨西哥卷	墨西哥卷 🌯️
墨西哥粽	墨西哥粽 🫔
墨镜笑脸	墨镜笑脸 😎
士多啤梨	士多啤梨 🍓️
复古钥匙	复古钥匙 🗝
复活节岛	复活节岛 🗿
复选按钮	复选按钮 ☑️
外卖包装	外卖包装 🥡
外带杯子	外带杯子 🥤
外星怪物	外星怪物 👾
多云间晴	多云间晴 🌤️
多明尼加	多明尼加 🇩🇴
多米尼克	多米尼克 🇩🇲
多米尼加	多米尼加 🇩🇴 🇩🇲
夜间大桥	夜间大桥 🌉
夜间的桥	夜间的桥 🌉️
大不列颠	大不列颠 🇬🇧
大于等于	大于等于 ≥
大写字母	大写字母 🔠
大卫之星	大卫之星 ✡️
大厦夕阳	大厦夕阳 🌇
大学生女	大学生女 👩🏻‍🎓
大学生男	大学生男 👨🏻‍🎓
大山日出	大山日出 🌄
大幅增高	大幅增高 ⏫️
大幅降低	大幅降低 ⏬️
大恩大德	大恩大德 🙏🏻️
大正方形	大正方形 ◾ ◽
大法官女	大法官女 👩🏻‍⚖️
大法官男	大法官男 👨🏻‍⚖️
大红灯笼	大红灯笼 🏮
大肚子女	大肚子女 🤰🏻
大肚子男	大肚子男 🫃🏻
大胡子女	大胡子女 🧔🏻‍♀️
大胡子男	大胡子男 🧔🏻‍♂️
大脑爆炸	大脑爆炸 🤯
大韩民国	大韩民国 🇰🇷
大麻烦女	大麻烦女 🤦🏻‍♀️
大麻烦男	大麻烦男 🤦🏻‍♂️
天主教堂	天主教堂 ⛪️
天使宝宝	天使宝宝 👼
太好了女	太好了女 🙆🏻‍♀️
太好了男	太好了男 🙆🏻‍♂️
太空人女	太空人女 👩🏻‍🚀
太空人男	太空人男 👨🏻‍🚀
头晕目眩	头晕目眩 😵 😵‍💫 💫
头晕眼花	头晕眼花 😵 😵‍💫
头部剪影	头部剪影 🗣
夹趾凉鞋	夹趾凉鞋 🩴
奈及利亚	奈及利亚 🇳🇬
奥兰群岛	奥兰群岛 🇦🇽
奥姆符号	奥姆符号 🕉
女修理工	女修理工 👩‍🔧
女农民工	女农民工 👷‍♀️
女化学家	女化学家 👩‍🔬
女双胞胎	女双胞胎 👨‍👩‍👧‍👧
女同性恋	女同性恋 👩‍❤️‍👩
女吸血鬼	女吸血鬼 🧛‍♀️
女士标志	女士标志 🚺
女士符号	女士符号 🚺
女士衬衫	女士衬衫 👚
女士钱包	女士钱包 👛
女大反派	女大反派 🦹‍♀️
女宇航员	女宇航员 👩‍🚀
女建筑工	女建筑工 👷‍♀️
女式凉鞋	女式凉鞋 👡
女技术员	女技术员 👩‍💻
女服务员	女服务员 💁‍♀️
女水管工	女水管工 👩‍🔧
女洗手间	女洗手间 🚺
女消防员	女消防员 👩‍🚒
女漫画家	女漫画家 👩‍🎨
女生举重	女生举重 🏋️‍♀️
女生冲浪	女生冲浪 🏄‍♀️
女生游泳	女生游泳 🏊‍♀️
女科学家	女科学家 👩‍🔬
女程序员	女程序员 👩‍💻
女穆斯林	女穆斯林 🧕🏾
女艺术家	女艺术家 👩‍🎨
女飞行员	女飞行员 👩‍✈️
女魔术师	女魔术师 🧙‍♀️
女魔法师	女魔法师 🧙‍♀️
奶油面包	奶油面包 🥯
奶酪火锅	奶酪火锅 🫕
好崇拜哦	好崇拜哦 🤩
如释重负	如释重负 😌
委内瑞拉	委内瑞拉 🇻🇪
婴儿厕所	婴儿厕所 🚼️
婴儿标志	婴儿标志 🚼
婴儿符号	婴儿符号 🚼
存入手机	存入手机 📲️
孟加拉国	孟加拉国 🇧🇩
学童过街	学童过街 🚸
孵化小鸡	孵化小鸡 🐣
宇航员女	宇航员女 👩🏻‍🚀
宇航员男	宇航员男 👨🏻‍🚀
安全别针	安全别针 🧷
安全背心	安全背心 🦺
安圭拉岛	安圭拉岛 🇦🇮
安静的脸	安静的脸 🤫
宏都拉斯	宏都拉斯 🇭🇳
害怕猫脸	害怕猫脸 🙀
害怕的猫	害怕的猫 🙀
家禽的腿	家禽的腿 🍗
容我三思	容我三思 🤔
寄存行李	寄存行李 🛅
对话气泡	对话气泡 💬 🗨 🗯
导入手机	导入手机 📲️
小于等于	小于等于 ≤
小写字母	小写字母 🔡
小圆点儿	小圆点儿 ⚪
小型飞机	小型飞机 🛩
小声点儿	小声点儿 🤫
小宝贝儿	小宝贝儿 👶
小心儿童	小心儿童 🚸️
小正方形	小正方形 ▪ ▫
小点儿声	小点儿声 🤫
小白点儿	小白点儿 ⚪
小童厕所	小童厕所 🚼️
小鸡破壳	小鸡破壳 🐣
小黑点儿	小黑点儿 ⚫
少儿不宜	少儿不宜 🔞️
尼加拉瓜	尼加拉瓜 🇳🇮
尼日利亚	尼日利亚 🇳🇬
山中日出	山中日出 🌄
山区铁路	山区铁路 🚞
山地单车	山地单车 🚵🏻
山地车女	山地车女 🚵🏻‍♀️
山地车男	山地车男 🚵🏻‍♂️
山地骑行	山地骑行 🚵🏻
山顶日出	山顶日出 🌄
山顶缆车	山顶缆车 🚠️
工厂工人	工厂工人 👨‍🏭 👩‍🏭
工程师女	工程师女 👩🏻‍💻 👷🏻‍♀️
工程师男	工程师男 👨🏻‍💻 👷🏻‍♂️
工薪阶层	工薪阶层 🧑🏻‍💼
左上箭头	左上箭头 ↖️ ↖
左下箭头	左下箭头 ↙️ ↙
左右箭头	左右箭头 ↔️ ↔︎
巧克力圈	巧克力圈 🍩️
巧克力棒	巧克力棒 🍫
巧克力饼	巧克力饼 🍪️
巴勒斯坦	巴勒斯坦 🇵🇸
巴哈马国	巴哈马国 🇧🇸
巴基斯坦	巴基斯坦 🇵🇰
巴巴多斯	巴巴多斯 🇧🇧
巴拉圭茶	巴拉圭茶 🧉
巴林王国	巴林王国 🇧🇭
巴西联邦	巴西联邦 🇧🇷
带吸管杯	带吸管杯 🥤
带框的画	带框的画 🖼
带锁行李	带锁行李 🛅️
干脆面君	干脆面君 🦝
幸运饼干	幸运饼干 🥠
床上休息	床上休息 🛌
库克群岛	库克群岛 🇨🇰
建筑工人	建筑工人 👷‍♂️ 👷‍♀️
建筑工地	建筑工地 🏗️
建筑工女	建筑工女 👷🏻‍♀️
建筑工男	建筑工男 👷🏻‍♂️
建筑施工	建筑施工 🏗
开发人员	开发人员 👨‍💻 👩‍💻
开始录像	开始录像 ⏺️
开始录音	开始录音 ⏺️
开始战斗	开始战斗 ⚔️
开始播放	开始播放 ▶️
开心猫脸	开心猫脸 😺
开心的猫	开心的猫 😺
开曼群岛	开曼群岛 🇰🇾
开门营业	开门营业 🈺
异形怪兽	异形怪兽 👾
张开双手	张开双手 👐
弹出按钮	弹出按钮 ⏏️
强忍泪水	强忍泪水 🥹
当心儿童	当心儿童 🚸
录像按钮	录像按钮 ⏺️
录音按钮	录音按钮 ⏺️
彩色碎纸	彩色碎纸 🎊
得意地笑	得意地笑 😏
得意猫脸	得意猫脸 😼
得意的猫	得意的猫 😼
循环再生	循环再生 ♻️
循环利用	循环利用 ♻️
循环播放	循环播放 🔁
微微不满	微微不满 🙁
微笑亲亲	微笑亲亲 😙
微笑天使	微笑天使 😇
微笑恶魔	微笑恶魔 😈
微笑猫脸	微笑猫脸 😸
微笑的猫	微笑的猫 😸
心中箭了	心中箭了 💘
心事重重	心事重重 😔
心在燃烧	心在燃烧 ❤️‍🔥
心在着火	心在着火 ❤️‍🔥
心型装饰	心型装饰 💟
心心相印	心心相印 💕️
心情不好	心情不好 🙁
心有灵犀	心有灵犀 💕️ 💞️
心脏器官	心脏器官 🫀
忍住泪水	忍住泪水 🥹
快进符号	快进符号 ⏩
快退符号	快退符号 ⏪
怎么可能	怎么可能 🤔️
怒火中烧	怒火中烧 😡
思考气泡	思考气泡 💭
恐惧尖叫	恐惧尖叫 😱
恐惧猫脸	恐惧猫脸 🙀
恐惧的猫	恐惧的猫 🙀
恶魔之眼	恶魔之眼 🧿
恶魔微笑	恶魔微笑 😈
恶魔生气	恶魔生气 👿
恶魔的眼	恶魔的眼 🧿
悬浮列车	悬浮列车 🚟️
情人宾馆	情人宾馆 🏩
情人旅店	情人旅店 🏩
情人旅馆	情人旅馆 🏩
情人酒店	情人酒店 🏩
情侣宾馆	情侣宾馆 🏩
情侣旅店	情侣旅店 🏩
情侣旅馆	情侣旅馆 🏩
情侣酒店	情侣酒店 🏩
惊声尖叫	惊声尖叫 😱
意大利面	意大利面 🍝
感激不尽	感激不尽 🙏🏻️
成双成对	成双成对 👫🏻️
成年女人	成年女人 👩
成年女性	成年女性 👩
成年男人	成年男人 👨
成年男性	成年男性 👨
我不敢看	我不敢看 🫣
我再想想	我再想想 🤔
我是证人	我是证人 👁️‍🗨️
我服了你	我服了你 🤦‍♂️ 🤦‍♀️
所以呢女	所以呢女 🤷🏻‍♀️
所以呢男	所以呢男 🤷🏻‍♂️
手动轮椅	手动轮椅 👨‍🦽 👩‍🦽 🦽
手指交叉	手指交叉 🤞
手指张开	手指张开 🖐
手指捏和	手指捏和 🤌
手掌捂脸	手掌捂脸 🤦‍♂️ 🤦‍♀️
手掌朝上	手掌朝上 🫴
手掌朝下	手掌朝下 🫳
手提电脑	手提电脑 💻
手撕日历	手撕日历 📆
手机信号	手机信号 📶
手机关机	手机关机 📴
手舞足蹈	手舞足蹈 🕺🏻
打开的书	打开的书 📖
打开的锁	打开的锁 🔓
打招呼女	打招呼女 🙋🏻‍♀️
打招呼男	打招呼男 🙋🏻‍♂️
打曲棍球	打曲棍球 🏒️
打篮球女	打篮球女 ⛹🏻‍♀️
打篮球男	打篮球男 ⛹🏻‍♂️
打高尔夫	打高尔夫 🏌️‍♂️ 🏌️‍♀️
扣在一起	扣在一起 🖇️
扬手欢呼	扬手欢呼 🙌
抛接杂耍	抛接杂耍 🤹‍♂️ 🤹‍♀️
护照检查	护照检查 🛂
抱在一起	抱在一起 🫂
拇指向上	拇指向上 👍 👎
拇指朝上	拇指朝上 👍
拇指朝下	拇指朝下 👎
拉上拉链	拉上拉链 🤐
拉普拉斯	拉普拉斯 ∇² ∇·∇
拉脱维亚	拉脱维亚 🇱🇻
拥抱的人	拥抱的人 🫂
拳击手套	拳击手套 🥊
按摩师女	按摩师女 💆🏻‍♀️
按摩师男	按摩师男 💆🏻‍♂️
挪威王国	挪威王国 🇳🇴
振动模式	振动模式 📳
捂上嘴巴	捂上嘴巴 🤭 🙊
捂上耳朵	捂上耳朵 🙉
捂住嘴巴	捂住嘴巴 🤭 🙊
捂住耳朵	捂住耳朵 🙉
捂着嘴巴	捂着嘴巴 🤭 🙊
捂着嘴笑	捂着嘴笑 🤭
捂着耳朵	捂着耳朵 🙉
掌心朝上	掌心朝上 🫴
掌心朝下	掌心朝下 🫳
接收天线	接收天线 📡
控制旋钮	控制旋钮 🎛
推出按钮	推出按钮 ⏏️
推杯换盏	推杯换盏 🍻️
搏动的心	搏动的心 💗
摇头晃脑	摇头晃脑 🫨
摇滚手势	摇滚手势 🤘
摇滚歌手	摇滚歌手 👨‍🎤 👩‍🎤
摔跤选手	摔跤选手 🤼‍♂️ 🤼‍♀️
摩尔多瓦	摩尔多瓦 🇲🇩
摩艾石像	摩艾石像 🗿
播放暂停	播放暂停 ⏯️
攀爬的人	攀爬的人 🧗‍♂️ 🧗‍♀️
收到来信	收到来信 📨
收到邮件	收到邮件 📨 📥
收费服务	收费服务 🈂️
收起的伞	收起的伞 🌂
放声大哭	放声大哭 😭
救火队女	救火队女 👩🏻‍🚒
救火队男	救火队男 👨🏻‍🚒
数字光盘	数字光盘 📀️
数字光碟	数字光碟 📀️
数字键盘	数字键盘 🔢️
数码光盘	数码光盘 📀️
数码光碟	数码光碟 📀️
斯威士兰	斯威士兰 🇸🇿
斯洛伐克	斯洛伐克 🇸🇰
斯里兰卡	斯里兰卡 🇱🇰
新加坡元	新加坡元 S$
新加坡币	新加坡币 S$
新娘中性	新娘中性 👰🏻️
方形按钮	方形按钮 🔳 🔲
施工符号	施工符号 🚧
旋转木马	旋转木马 🎠
旋转的心	旋转的心 💞
无人荒岛	无人荒岛 🏝
无所谓女	无所谓女 🤷🏻‍♀️
无所谓男	无所谓男 🤷🏻‍♂️
无线网络	无线网络 🛜
无能为力	无能为力 🤷🏻
无轨电车	无轨电车 🚎
日元钞票	日元钞票 💴
日式城堡	日式城堡 🏯
日本人偶	日本人偶 🎎
日本人形	日本人形 🎎
日本剪影	日本剪影 🗾
日本地图	日本地图 🗾
日本城堡	日本城堡 🏯
日本娃娃	日本娃娃 🎎
日本神社	日本神社 ⛩
日本邮局	日本邮局 🏣
旭日东升	旭日东升 🌄 🌅
昏昏沉沉	昏昏沉沉 🥴
星际迷航	星际迷航 🖖
晓不得女	晓不得女 🤷🏻‍♀️
晓不得男	晓不得男 🤷🏻‍♂️
晕头转向	晕头转向 😵 😵‍💫
晴偶有云	晴偶有云 🌤
晴时多云	晴时多云 🌤️
智能手机	智能手机 📱
暗夜精灵	暗夜精灵 🧝🏻
曲奇饼干	曲奇饼干 🍪
曲棍网球	曲棍网球 🥍
月黑风高	月黑风高 🌚️
有环行星	有环行星 🪐
有蛋的巢	有蛋的巢 🪺
有轨电车	有轨电车 🚋
服了你了	服了你了 🤦‍♂️ 🤦‍♀️
服务员女	服务员女 💁🏻‍♀️
服务员男	服务员男 💁🏻‍♂️
朱古力圈	朱古力圈 🍩️
朱古力棒	朱古力棒 🍫
朱古力饼	朱古力饼 🍪️
机械手臂	机械手臂 🦾
来一根儿	来一根儿 🚬
杯式蛋糕	杯式蛋糕 🧁
松了口气	松了口气 😌
枯萎的花	枯萎的花 🥀
树懒先生	树懒先生 🦥
株式会社	株式会社 ㍿
格林纳达	格林纳达 🇬🇩
格瑞那达	格瑞那达 🇬🇩
格鲁吉亚	格鲁吉亚 🇬🇪
梅利利亚	梅利利亚 🇪🇦
检查护照	检查护照 🛂
棕色的心	棕色的心 🤎
椒盐卷饼	椒盐卷饼 🥨
模里西斯	模里西斯 🇲🇺
橘色书本	橘色书本 📙
橘色的书	橘色的书 📙
橘色的心	橘色的心 🧡
橘色菱形	橘色菱形 🔶
橙色书本	橙色书本 📙
橙色的书	橙色的书 📙
橙色的心	橙色的心 🧡
橙色菱形	橙色菱形 🔶
欧元钞票	欧元钞票 💶
欧式城堡	欧式城堡 🏰
欧洲城堡	欧洲城堡 🏰
欧洲联盟	欧洲联盟 🇪🇺
欧洲邮局	欧洲邮局 🏤
欧洲非洲	欧洲非洲 🌍
止血胶布	止血胶布 🩹
正中红心	正中红心 🎯️
残疾人女	残疾人女 👩🏻‍🦼 👩🏻‍🦽
残疾人男	残疾人男 👨🏻‍🦼 👨🏻‍🦽
母乳喂养	母乳喂养 🤱
比心手势	比心手势 🫰 🫶
毛里求斯	毛里求斯 🇲🇺
民主刚果	民主刚果 🇨🇩
水果蛋糕	水果蛋糕 🍰
水果饮料	水果饮料 🍹
求救信号	求救信号 🆘
求救讯号	求救讯号 🆘
求求你了	求求你了 🥺 🙏
汤加王国	汤加王国 🇹🇴
沙发和灯	沙发和灯 🛋
沙滩凉鞋	沙滩凉鞋 🩴
沙滩阳伞	沙滩阳伞 ⛱️
没有嘴巴	没有嘴巴 😶
没有空位	没有空位 🈵
没有邮件	没有邮件 📪️
没脸见人	没脸见人 🙈️
油炸面圈	油炸面圈 🍩
油酥点心	油酥点心 🥧
治愈的心	治愈的心 ❤️‍🩹
法国王室	法国王室 ⚜️
法罗群岛	法罗群岛 🇫🇴
法轮大法	法轮大法 ☸️
泡澡的人	泡澡的人 🛀
波利维亚	波利维亚 🇧🇴
波多黎各	波多黎各 🇵🇷
波霸奶茶	波霸奶茶 🧋
注册商标	注册商标 ®
注册标记	注册标记 ®
注意儿童	注意儿童 🚸
洗澡的人	洗澡的人 🛀
津巴布韦	津巴布韦 🇿🇼
津津有味	津津有味 😋
洪都拉斯	洪都拉斯 🇭🇳
海上日出	海上日出 🌅️
海关检查	海关检查 🛃
海底世界	海底世界 🐳️
海洋世界	海洋世界 🐳️
海滩阳伞	海滩阳伞 ⛱️
涂指甲油	涂指甲油 💅
消防员女	消防员女 👩🏻‍🚒
消防员男	消防员男 👨🏻‍🚒
淡蓝色心	淡蓝色心 🩵
深思的脸	深思的脸 🤔
游戏手柄	游戏手柄 🎮
游戏摇杆	游戏摇杆 🕹
滑动开关	滑动开关 🎚️
滑雪的人	滑雪的人 ⛷️
滑雪装备	滑雪装备 🎿
满面寒霜	满面寒霜 🥶
潜水面罩	潜水面罩 🤿
澳大利亚	澳大利亚 🇦🇺
澳洲亚洲	澳洲亚洲 🌏
火上之心	火上之心 ❤️‍🔥
火山喷发	火山喷发 🌋
火山爆发	火山爆发 🌋
灭火队女	灭火队女 👩🏻‍🚒
灭火队男	灭火队男 👨🏻‍🚒
灰色的心	灰色的心 🩶
炸豆丸子	炸豆丸子 🧆
烂玩意儿	烂玩意儿 😒️
热带饮料	热带饮料 🍹
焦头烂额	焦头烂额 😖
焦糖奶油	焦糖奶油 🍮️
煎饼馃子	煎饼馃子 🌯
煮熟的饭	煮熟的饭 🍚
燃烧的心	燃烧的心 ❤️‍🔥
爱你手势	爱你手势 🤟
爱心环绕	爱心环绕 🥰
爱情宾馆	爱情宾馆 🏩
爱情旅店	爱情旅店 🏩
爱情旅馆	爱情旅馆 🏩
爱情酒店	爱情酒店 🏩
爱沙尼亚	爱沙尼亚 🇪🇪
爱的礼物	爱的礼物 💝
版权符号	版权符号 ©
牛仔帽脸	牛仔帽脸 🤠
牛角面包	牛角面包 🥐
犹太教堂	犹太教堂 🕍
狗娘养的	狗娘养的 🤬
独角兽头	独角兽头 🦄
独角兽脸	独角兽脸 🦄
狮子山国	狮子山国 🇸🇱
玫瑰花结	玫瑰花结 🏵
玻利维亚	玻利维亚 🇧🇴
珍珠奶茶	珍珠奶茶 🧋
班主住女	班主住女 👩🏻‍🏫
班主住男	班主住男 👨🏻‍🏫
瑞典王国	瑞典王国 🇸🇪
瑞士联邦	瑞士联邦 🇨🇭
瓜地洛普	瓜地洛普 🇬🇵
瓜地马拉	瓜地马拉 🇬🇹
瓜德罗普	瓜德罗普 🇬🇵
瓦努阿图	瓦努阿图 🇻🇺
生化危机	生化危机 ☣️
生化武器	生化武器 ☣️
生化物质	生化物质 ☣️
生日蛋糕	生日蛋糕 🎂
生气恶魔	生气恶魔 👿
生气猫脸	生气猫脸 😾
生气的猫	生气的猫 😾
生气符号	生气符号 💢
生物危害	生物危害 ☣️
生物科技	生物科技 🧬
电力火车	电力火车 🚊️
电动火车	电动火车 🚊️
电动轮椅	电动轮椅 👨‍🦼 👩‍🦼 🦼
电子邮件	电子邮件 📧
电平滑块	电平滑块 🎚
电影胶片	电影胶片 🎞
电池不足	电池不足 🪫
电源插头	电源插头 🔌
电脑光盘	电脑光盘 💽
电脑键盘	电脑键盘 ⌨️
电脑鼠标	电脑鼠标 🖱
电话听筒	电话听筒 📞
男人怀孕	男人怀孕 🫃
男修理工	男修理工 👨‍🔧
男农民工	男农民工 👷‍♂️
男化学家	男化学家 👨‍🔬
男双胞胎	男双胞胎 👨‍👩‍👦‍👦
男同性恋	男同性恋 👨‍❤️‍👨
男吸血鬼	男吸血鬼 🧛‍♂️
男士标志	男士标志 🚹
男士符号	男士符号 🚹
男士衬衫	男士衬衫 👕
男大反派	男大反派 🦹‍♂️
男宇航员	男宇航员 👨‍🚀
男建筑工	男建筑工 👷‍♂️
男技术员	男技术员 👨‍💻
男服务员	男服务员 💁‍♂️
男水管工	男水管工 👨‍🔧
男洗手间	男洗手间 🚹
男消防员	男消防员 👨‍🚒
男漫画家	男漫画家 👨‍🎨
男生举重	男生举重 🏋️‍♂️
男生冲浪	男生冲浪 🏄‍♂️
男生游泳	男生游泳 🏊‍♂️
男科学家	男科学家 👨‍🔬
男程序员	男程序员 👨‍💻
男艺术家	男艺术家 👨‍🎨
男飞行员	男飞行员 👨‍✈️
男魔术师	男魔术师 🧙‍♂️
男魔法师	男魔法师 🧙‍♂️
疑问惊叹	疑问惊叹 ⁉️
登山列车	登山列车 🚞️
白中有黑	白中有黑 🔳️
白俄罗斯	白俄罗斯 🇧🇾
白发女人	白发女人 👩‍🦳
白发女子	白发女子 👩‍🦳
白发男人	白发男人 👨‍🦳
白发男子	白发男子 👨‍🦳
白大褂儿	白大褂儿 🥼
白头发女	白头发女 👩🏻‍🦳
白头发男	白头发男 👨🏻‍🦳
白惊叹号	白惊叹号 ❕
白感叹号	白感叹号 ❕
白日小云	白日小云 🌤
白色叹号	白色叹号 ❕
白色头发	白色头发 👨‍🦳 👩‍🦳
白色旗子	白色旗子 🏳
白色旗帜	白色旗帜 🏳
白色的心	白色的心 🤍
白色的花	白色的花 💮
白色问号	白色问号 ❔
百合花饰	百合花饰 ⚜️
百货商店	百货商店 🏬
百货大楼	百货大楼 🏬️
皱着眉头	皱着眉头 🙍‍♂️ 🙍‍♀️
盆栽植物	盆栽植物 🪴
盒装饮料	盒装饮料 🧃
目瞪口呆	目瞪口呆 😦
直升飞机	直升飞机 🚁
直布罗陀	直布罗陀 🇬🇮
眉毛上挑	眉毛上挑 🤨
真的假的	真的假的 😳️
眯眼吐舌	眯眼吐舌 😝
眼冒星星	眼冒星星 🤩
睡眠符号	睡眠符号 💤
睡觉的人	睡觉的人 🛌
知识份子	知识份子 🤓️
研究员女	研究员女 👩🏻‍🔬
研究员男	研究员男 👨🏻‍🔬
破玩意儿	破玩意儿 😒️
碎花彩球	碎花彩球 🎊
禁丢垃圾	禁丢垃圾 🚯
禁打电话	禁打电话 📵️
禁止单车	禁止单车 🚳️
禁止吸烟	禁止吸烟 🚭
禁止响铃	禁止响铃 🔕
禁止手势	禁止手势 🙅‍♂️ 🙅‍♀️
禁止行人	禁止行人 🚷
禁止通行	禁止通行 ⛔
禁止饮水	禁止饮水 🚱️
禁止饮用	禁止饮用 🚱️
禁止驶入	禁止驶入 ⛔
禁止骑行	禁止骑行 🚳
禁止骑车	禁止骑车 🚳
禁用手机	禁用手机 📵️
科威特国	科威特国 🇰🇼
科学上网	科学上网 🪜
科学家女	科学家女 👩🏻‍🔬
科学家男	科学家男 👨🏻‍🔬
科特迪瓦	科特迪瓦 🇨🇮
科研人员	科研人员 🧑🏻‍🔬
移动热点	移动热点 🛜
移动电话	移动电话 📱
移动的星	移动的星 💫️
程序员女	程序员女 👩🏻‍💻
程序员男	程序员男 👨🏻‍💻
穴居巨怪	穴居巨怪 🧌
空中缆车	空中缆车 🚡
空手道服	空手道服 🥋
空气不好	空气不好 🌁️
空气污染	空气污染 🏭️ 😷️
突尼西亚	突尼西亚 🇹🇳
笑中带泪	笑中带泪 😹
笑出眼泪	笑出眼泪 🤣 😂
笑得打滚	笑得打滚 🤣
符号键盘	符号键盘 🔣️
管弦乐器	管弦乐器 🎷
粉色的心	粉色的心 💕 🩷
精灵族女	精灵族女 🧝🏻‍♀️
精灵族男	精灵族男 🧝🏻‍♂️
糯米丸子	糯米丸子 🍡️
索马利亚	索马利亚 🇸🇴
紫色的心	紫色的心 💜
红发女人	红发女人 👩‍🦰
红发女子	红发女子 👩‍🦰
红发男人	红发男人 👨‍🦰 👨‍🦱
红发男子	红发男子 👨‍🦰 👨‍🦱
红头发女	红头发女 👩🏻‍🦰
红头发男	红头发男 👨🏻‍🦰
红毛猩猩	红毛猩猩 🦧
红色书本	红色书本 📕
红色头发	红色头发 👨‍🦰 👩‍🦰 🦰
红色旗帜	红色旗帜 🚩
红色的书	红色的书 📕
纳扎尔球	纳扎尔球 🧿
纳米比亚	纳米比亚 🇳🇦
纸杯蛋糕	纸杯蛋糕 🧁
线圈日历	线圈日历 🗓
结婚戒指	结婚戒指 💍️
络腮胡女	络腮胡女 🧔🏻‍♀️
络腮胡男	络腮胡男 🧔🏻‍♂️
绣珍光盘	绣珍光盘 💽️
绣珍光碟	绣珍光碟 💽️
绿叶蔬菜	绿叶蔬菜 🥬
绿皮火车	绿皮火车 🚆
绿色书本	绿色书本 📗
绿色沙拉	绿色沙拉 🥗
绿色的书	绿色的书 📗
绿色的心	绿色的心 💚
绿花椰菜	绿花椰菜 🥦
缅甸联邦	缅甸联邦 🇲🇲
缠满绷带	缠满绷带 🤕
罐头食品	罐头食品 🥫
罗马尼亚	罗马尼亚 🇷🇴
羊角面包	羊角面包 🥐
美元钞票	美元钞票 💵
美容美发	美容美发 💇‍♂️ 💇‍♀️
美式九球	美式九球 🎱️
美式足球	美式足球 🏈
羞涩亲亲	羞涩亲亲 😚
羽毛球拍	羽毛球拍 🏸
翻白眼儿	翻白眼儿 🙄
老式钥匙	老式钥匙 🗝
聊天气泡	聊天气泡 💬️
聋哑人女	聋哑人女 🧏🏻‍♀️
聋哑人男	聋哑人男 🧏🏻‍♂️
肱二头肌	肱二头肌 💪
能见度低	能见度低 🌁️
脑子爆炸	脑子爆炸 🤯
脑袋爆炸	脑袋爆炸 🤯
膨胀的心	膨胀的心 💗
自动轮椅	自动轮椅 🦼
自然风光	自然风光 🏞️
自由女神	自由女神 🗽
自由泳女	自由泳女 🏊🏻‍♀️
自由泳男	自由泳男 🏊🏻‍♂️
舞动之心	舞动之心 💞️
舞动的心	舞动的心 💞
航班起飞	航班起飞 🛫
航班降落	航班降落 🛬
艺术家女	艺术家女 👩🏻‍🎨
艺术家男	艺术家男 👨🏻‍🎨
节哀顺变	节哀顺变 💮️
芝士火锅	芝士火锅 🫕
芭蕾舞鞋	芭蕾舞鞋 🩰
花扑克牌	花扑克牌 🎴
花痴猫脸	花痴猫脸 😻
花痴的猫	花痴的猫 😻
英式足球	英式足球 ⚽
英文大写	英文大写 🔠
英文小写	英文小写 🔡
英文键盘	英文键盘 🔤️
英镑钞票	英镑钞票 💷
草本植物	草本植物 🌿
荷属沙巴	荷属沙巴 🇧🇶
莫三比克	莫三比克 🇲🇿
莫桑比克	莫桑比克 🇲🇿
萨克斯管	萨克斯管 🎷
萨克斯风	萨克斯风 🎷
萨尔瓦多	萨尔瓦多 🇸🇻
葡萄酒杯	葡萄酒杯 🍷️
蒙住眼睛	蒙住眼睛 🙈
蒸桑拿女	蒸桑拿女 🧖🏻‍♀️
蒸桑拿男	蒸桑拿男 🧖🏻‍♂️
蒸汽机车	蒸汽机车 🚂️
蒸汽火车	蒸汽火车 🚂
蓝色书本	蓝色书本 📘
蓝色的书	蓝色的书 📘
蓝色的心	蓝色的心 💙 🩵
蓝色菱形	蓝色菱形 🔷
蔬菜沙拉	蔬菜沙拉 🥗
蔬菜色拉	蔬菜色拉 🥗
虚线轮廓	虚线轮廓 🫥
蝴蝶脆饼	蝴蝶脆饼 🥨
螺丝扳手	螺丝扳手 🔧
螺母螺栓	螺母螺栓 🔩
行人止歩	行人止歩 🚷️
行尸走肉	行尸走肉 🧟‍♂️ 🧟‍♀️
行李寄存	行李寄存 🛅
行李领取	行李领取 🛄
衣索比亚	衣索比亚 🇪🇹
表演艺术	表演艺术 🎭
衬衫领带	衬衫领带 👔
西撒哈拉	西撒哈拉 🇪🇭
西部牛仔	西部牛仔 🤠
见钱眼开	见钱眼开 🤑
认不得女	认不得女 🤷🏻‍♀️
认不得男	认不得男 🤷🏻‍♂️
讨价还价	讨价还价 🉐
让人失望	让人失望 ☹️
请勿入内	请勿入内 ⛔
请勿吸烟	请勿吸烟 🚭
请勿饮用	请勿饮用 🚱
请勿驶入	请勿驶入 ⛔
诺福克岛	诺福克岛 🇳🇫
谁知道呢	谁知道呢 🤷‍♂️ 🤷‍♀️
象牙海岸	象牙海岸 🇨🇮
货币兑换	货币兑换 💱
赖比瑞亚	赖比瑞亚 🇱🇷
赛博朋克	赛博朋克 🦾 🦿
赛普勒斯	赛普勒斯 🇨🇾
赛车比赛	赛车比赛 🏁️
赛马骑师	赛马骑师 🏇
起司火锅	起司火锅 🫕
超级英雄	超级英雄 🦸‍♂️ 🦸‍♀️
趾高气昂	趾高气昂 😤
跆拳道服	跆拳道服 🥋
跨性别旗	跨性别旗 🏳️‍⚧️
轮椅标志	轮椅标志 ♿
软冰淇淋	软冰淇淋 🍦
软冰激凌	软冰激凌 🍦
轻轨电车	轻轨电车 🚈
较浅肤色	较浅肤色 🏼
较深肤色	较深肤色 🏾
达朗贝尔	达朗贝尔 ☐²
运动背心	运动背心 🎽
近视眼镜	近视眼镜 👓️
连体泳衣	连体泳衣 🩱
迷你光盘	迷你光盘 💽
迷你光碟	迷你光碟 💽
道路施工	道路施工 🚧️
遗传物质	遗传物质 🧬
邮政喇叭	邮政喇叭 📯
都市景观	都市景观 🏙
都市风光	都市风光 🏙
酒桌游戏	酒桌游戏 🎲
酷炫狂跩	酷炫狂跩 😎️
重拳出击	重拳出击 👊
重新载入	重新载入 🔃
金发女人	金发女人 👱 👱‍♀️
金发女子	金发女子 👱 👱‍♀️
金发男人	金发男人 👱‍♂️
金发男子	金发男子 👱‍♂️
金色头发	金色头发 👱 👱‍♀️ 👱‍♂️
钢琴按键	钢琴按键 🎹
钱包丢了	钱包丢了 💸️
锤子与镐	锤子与镐 ⚒️
锤子和镐	锤子和镐 ⚒️
锤子扳手	锤子扳手 🛠
长曲棍球	长曲棍球 🥍
长棍面包	长棍面包 🥖
闪亮之心	闪亮之心 💖️
闪亮的心	闪亮的心 💖
闪闪发光	闪闪发光 🌟️
闭目养神	闭目养神 😑️
阿兰群岛	阿兰群岛 🇦🇽
阿塞拜彊	阿塞拜彊 🇦🇿
阿塞拜疆	阿塞拜疆 🇦🇿
阿弥陀佛	阿弥陀佛 🙏
阿根廷茶	阿根廷茶 🧉
阿森松岛	阿森松岛 🇦🇨
阿鲁巴岛	阿鲁巴岛 🇦🇼
陷入爱河	陷入爱河 🥰
随机播放	随机播放 🔀
隐瞒身份	隐瞒身份 🥸
静音铃铛	静音铃铛 🔕
非常感谢	非常感谢 🙏🏻️
非洲欧洲	非洲欧洲 🌍
非礼勿听	非礼勿听 🙉
非礼勿视	非礼勿视 🙈
非礼勿言	非礼勿言 🙊
非饮用水	非饮用水 🚱
面无表情	面无表情 😑
鞠躬勋章	鞠躬勋章 🎖
音乐键盘	音乐键盘 🎹
领取行李	领取行李 🛄
颠倒的脸	颠倒的脸 🙃
颤抖的脸	颤抖的脸 🫨
飞机着陆	飞机着陆 🛬
飞机起飞	飞机起飞 🛫
马丁尼克	马丁尼克 🇲🇶
马尔代夫	马尔代夫 🇲🇻
马尔地夫	马尔地夫 🇲🇻
马拉卡斯	马拉卡斯 🪇
马提尼克	马提尼克 🇲🇶
马来西亚	马来西亚 🇲🇾
马桶吸把	马桶吸把 🪠
马桶吸盘	马桶吸盘 🪠
马桶抽子	马桶抽子 🪠
马桶搋子	马桶搋子 🪠
骑单车女	骑单车女 🚴🏻‍♀️
骑单车男	骑单车男 🚴🏻‍♂️
骑山地车	骑山地车 🚵‍♂️ 🚵‍♀️
骑自行车	骑自行车 🚴‍♂️ 🚴‍♀️
高尔夫女	高尔夫女 🏌🏻‍♀️
高尔夫球	高尔夫球 🏌🏻️
高尔夫男	高尔夫男 🏌🏻‍♂️
高山索道	高山索道 🚠
高架铁路	高架铁路 🚟
高跟儿靴	高跟儿靴 👢
高跟儿鞋	高跟儿鞋 👠
高跟凉鞋	高跟凉鞋 👡
高速公路	高速公路 🛣
高速列车	高速列车 🚄 🚅
高音谱号	高音谱号 𝄞
鬼话连篇	鬼话连篇 🙄️
魔法上网	魔法上网 🪜
魔法师女	魔法师女 🧙🏻‍♀️
魔法师男	魔法师男 🧙🏻‍♂️
鲸鱼喷水	鲸鱼喷水 🐳️
鹰嘴豆饼	鹰嘴豆饼 🧆
黄色的心	黄色的心 💛
黑中有白	黑中有白 🔲️
黑色小鸟	黑色小鸟 🐦‍⬛
黑色旗子	黑色旗子 🏴
黑色旗帜	黑色旗帜 🏴
黑色的心	黑色的心 🖤
鼻子冒气	鼻子冒气 😤
龇牙咧嘴	龇牙咧嘴 😬
三叉戟标志	三叉戟标志 🔱
三轮摩托车	三轮摩托车 🛺
不关我事女	不关我事女 🤷🏻‍♀️
不关我事男	不关我事男 🤷🏻‍♂️
不明飞行物	不明飞行物 🛸
中东蔬菜球	中东蔬菜球 🧆
中等正方形	中等正方形 ◼ ◻
中等浅肤色	中等浅肤色 🏼
中等深肤色	中等深肤色 🏾
中非共和国	中非共和国 🇨🇫
举起的拳头	举起的拳头 ✊
举重运动员	举重运动员 🏋️‍♂️ 🏋️‍♀️
乍得共和国	乍得共和国 🇹🇩
也门共和国	也门共和国 🇾🇪
五彩纸屑球	五彩纸屑球 🎊
亚洲地球仪	亚洲地球仪 🌏
亚澳地球仪	亚澳地球仪 🌏
交叉的手指	交叉的手指 🤞
交通信号灯	交通信号灯 🚥 🚦
俄罗斯套娃	俄罗斯套娃 🪆
俄罗斯联邦	俄罗斯联邦 🇷🇺
信号强度条	信号强度条 📶
克利珀顿岛	克利珀顿岛 🇨🇵
克罗埃西亚	克罗埃西亚 🇭🇷
八轮辐星号	八轮辐星号 ✳️
公共汽车站	公共汽车站 🚏
冒热气的碗	冒热气的碗 🍜
几内亚比索	几内亚比索 🇬🇼
几内亚比绍	几内亚比绍 🇬🇼
列支敦士登	列支敦士登 🇱🇮
列支敦斯登	列支敦斯登 🇱🇮
刚果（布）	刚果（布） 🇨🇬
刚果（金）	刚果（金） 🇨🇩
办公室职员	办公室职员 👨‍💼 👩‍💼
加纳共和国	加纳共和国 🇬🇭
加纳利群岛	加纳利群岛 🇮🇨
加那利群岛	加那利群岛 🇮🇨
十字安全帽	十字安全帽 ⛑️
南非共和国	南非共和国 🇿🇦
卡片存档盒	卡片存档盒 🗃
印度共和国	印度共和国 🇮🇳
印度尼西亚	印度尼西亚 🇮🇩
卷起的报纸	卷起的报纸 🗞
厄立特里亚	厄立特里亚 🇪🇷
受伤的心灵	受伤的心灵 ❤️‍🩹
古巴共和国	古巴共和国 🇨🇺
古老的钥匙	古老的钥匙 🗝
向右伸的手	向右伸的手 🫱
向右推的手	向右推的手 🫸
向左伸的手	向左伸的手 🫲
向左推的手	向左推的手 🫷
含泪的笑脸	含泪的笑脸 🥲
和平的象征	和平的象征 🕊
哈萨克斯坦	哈萨克斯坦 🇰🇿
哥斯大黎加	哥斯大黎加 🇨🇷
哥斯达黎加	哥斯达黎加 🇨🇷
哺乳的女人	哺乳的女人 👩‍🍼
哺乳的男人	哺乳的男人 👨‍🍼
唔关我事女	唔关我事女 🤷🏻‍♀️
唔关我事男	唔关我事男 🤷🏻‍♂️
喷水的鲸鱼	喷水的鲸鱼 🐳
四轮滑冰鞋	四轮滑冰鞋 🛼
国际象棋兵	国际象棋兵 ♟
圆筒冰淇淋	圆筒冰淇淋 🍦
圆筒冰激凌	圆筒冰激凌 🍦
土库曼斯坦	土库曼斯坦 🇹🇲
圣佑达修斯	圣佑达修斯 🇧🇶
圣巴泰勒米	圣巴泰勒米 🇧🇱
圣诞老奶奶	圣诞老奶奶 🤶🏻
圣诞老爷爷	圣诞老爷爷 🎅🏻
垂斯坦昆哈	垂斯坦昆哈 🇸🇭
垃圾丢弃处	垃圾丢弃处 🚮
埃塞俄比亚	埃塞俄比亚 🇪🇹
塔吉克斯坦	塔吉克斯坦 🇹🇯
墨西哥卷饼	墨西哥卷饼 🌮 🌯
墨西哥粽子	墨西哥粽子 🫔
多哥共和国	多哥共和国 🇹🇬
多米尼克国	多米尼克国 🇩🇲
夜幕下的桥	夜幕下的桥 🌉
夜间的大桥	夜间的大桥 🌉
大拇指向上	大拇指向上 👍
大拇指向下	大拇指向下 👎
大拇指朝上	大拇指朝上 👍
大拇指朝下	大拇指朝下 👎
天使的翅膀	天使的翅膀 🪽
头戴式耳机	头戴式耳机 🎧
女医护人员	女医护人员 👩‍⚕️
女工厂工人	女工厂工人 👩‍🏭
女建筑工人	女建筑工人 👷‍♀️
女开发人员	女开发人员 👩‍💻
女摇滚歌手	女摇滚歌手 👩‍🎤
女生玩水球	女生玩水球 🤽‍♀️
女行尸走肉	女行尸走肉 🧟‍♀️
女超级英雄	女超级英雄 🦸‍♀️
安道尔公国	安道尔公国 🇦🇩
实验室外衣	实验室外衣 🥼
小型摩托车	小型摩托车 🛵
居酒屋灯笼	居酒屋灯笼 🏮
山地单车女	山地单车女 🚵🏻‍♀️
山地单车男	山地单车男 🚵🏻‍♂️
山地自行车	山地自行车 🚵‍♂️ 🚵‍♀️
山地骑行女	山地骑行女 🚵🏻‍♀️
山地骑行男	山地骑行男 🚵🏻‍♂️
工薪阶层女	工薪阶层女 👩🏻‍💼
工薪阶层男	工薪阶层男 👨🏻‍💼
布吉纳法索	布吉纳法索 🇧🇫
布基纳法索	布基纳法索 🇧🇫
希腊共和国	希腊共和国 🇬🇷
帕劳共和国	帕劳共和国 🇵🇼
带卷边的纸	带卷边的纸 📃
平行四边形	平行四边形 ⏥
废弃的房屋	废弃的房屋 🏚
建筑工人女	建筑工人女 👷🏻‍♀️
建筑工人男	建筑工人男 👷🏻‍♂️
录音麦克风	录音麦克风 🎙
微笑的太阳	微笑的太阳 🌞
微笑的恶魔	微笑的恶魔 😈
微笑的新月	微笑的新月 🌚
微笑的月亮	微笑的月亮 🌝
微笑的朔月	微笑的朔月 🌚
微笑的满月	微笑的满月 🌝
德意志联邦	德意志联邦 🇩🇪
怀孕的男人	怀孕的男人 🫃
意大利面条	意大利面条 🍝
感叹号问号	感叹号问号 ⁉️
愤怒对话框	愤怒对话框 🗯
我服了你了	我服了你了 🤦‍♂️ 🤦‍♀️
戴头巾的人	戴头巾的人 👳‍♂️ 👳‍♀️
戴头纱的人	戴头纱的人 👰‍♀️
戴王冠的人	戴王冠的人 🫅
所罗门群岛	所罗门群岛 🇸🇧
手动刮胡刀	手动刮胡刀 🪒
打开文件夹	打开文件夹 📂️
打开档案夹	打开档案夹 📂️
打开的书本	打开的书本 📖
打电话给我	打电话给我 🤙
扬声器关闭	扬声器关闭 🔇
护照检查处	护照检查处 🛂
拄盲杖的人	拄盲杖的人 👨‍🦯 👩‍🦯
捷克共和国	捷克共和国 🇨🇿
握紧的拳头	握紧的拳头 👊
摇滚女歌手	摇滚女歌手 👩‍🎤
摇滚男歌手	摇滚男歌手 👨‍🎤
摩洛哥王国	摩洛哥王国 🇲🇦
摩纳哥公国	摩纳哥公国 🇲🇨
攀爬的女人	攀爬的女人 🧗‍♀️
攀爬的男人	攀爬的男人 🧗‍♂️
收起的雨伞	收起的雨伞 🌂
放着勺的碗	放着勺的碗 🥣
斐济共和国	斐济共和国 🇫🇯
斯洛文尼亚	斯洛文尼亚 🇸🇮
斯洛维尼亚	斯洛维尼亚 🇸🇮
新月形面包	新月形面包 🥐
方程式赛车	方程式赛车 🏎
无线局域网	无线局域网 🛜
无能为力女	无能为力女 🤷🏻‍♀️
无能为力男	无能为力男 🤷🏻‍♂️
无障碍设施	无障碍设施 ♿️
智利共和国	智利共和国 🇨🇱
暗夜精灵女	暗夜精灵女 🧝🏻‍♀️
暗夜精灵男	暗夜精灵男 🧝🏻‍♂️
有胡子的人	有胡子的人 🧔
有胡须的人	有胡须的人 🧔
有蛋的鸟巢	有蛋的鸟巢 🪺
朝右的拳头	朝右的拳头 🤜
朝左的拳头	朝左的拳头 🤛
未成年不宜	未成年不宜 🔞
松了一口气	松了一口气 😌
枯萎的玫瑰	枯萎的玫瑰 🥀
柬埔寨王国	柬埔寨王国 🇰🇭
梵蒂冈城国	梵蒂冈城国 🇻🇦
橘色大菱形	橘色大菱形 🔶
橘色小菱形	橘色小菱形 🔸
橘黄色菱形	橘黄色菱形 🔶
橙色大菱形	橙色大菱形 🔶
橙色小菱形	橙色小菱形 🔸
欧洲地球仪	欧洲地球仪 🌍
欧非地球仪	欧非地球仪 🌍
残疾人设施	残疾人设施 ♿️
比利时王国	比利时王国 🇧🇪
毛里塔尼亚	毛里塔尼亚 🇲🇷
沙特阿拉伯	沙特阿拉伯 🇸🇦
没有新邮件	没有新邮件 📬️
法属圣马丁	法属圣马丁 🇲🇫
法属圭亚那	法属圭亚那 🇬🇫
法蒂玛之手	法蒂玛之手 🪬
波兰共和国	波兰共和国 🇵🇱
派对礼宾花	派对礼宾花 🎉
海地共和国	海地共和国 🇭🇹
淡蓝色的心	淡蓝色的心 🩵
游戏操控杆	游戏操控杆 🕹
澳亚地球仪	澳亚地球仪 🌏
澳洲地球仪	澳洲地球仪 🌏
爱你的手势	爱你的手势 🤟
牵手的情侣	牵手的情侣 👫
犹太教会堂	犹太教会堂 🕍
玛利亚之手	玛利亚之手 🪬
玻利维亚国	玻利维亚国 🇧🇴
理发店招牌	理发店招牌 💈
瑙鲁共和国	瑙鲁共和国 🇳🇷
瓦肯举手礼	瓦肯举手礼 🖖
生气的恶魔	生气的恶魔 👿
电影摄影机	电影摄影机 🎥
电影放映机	电影放映机 📽
男医护人员	男医护人员 👨‍⚕️
男工厂工人	男工厂工人 👨‍🏭
男建筑工人	男建筑工人 👷‍♂️
男开发人员	男开发人员 👨‍💻
男摇滚歌手	男摇滚歌手 👨‍🎤
男生玩水球	男生玩水球 🤽‍♂️
男行尸走肉	男行尸走肉 🧟‍♂️
男超级英雄	男超级英雄 🦸‍♂️
疑问惊叹号	疑问惊叹号 ⁉️
白十字头盔	白十字头盔 ⛑️
白色中方块	白色中方块 ◼
白色大方块	白色大方块 ◾
白色小方块	白色小方块 ▪
白色惊叹号	白色惊叹号 ❕
白色感叹号	白色感叹号 ❕
皮塔三明治	皮塔三明治 🥙
皮特肯群岛	皮特肯群岛 🇵🇳
盘腿的女人	盘腿的女人 🧘‍♀️
盘腿的男人	盘腿的男人 🧘‍♂️
禁止丢垃圾	禁止丢垃圾 🚯
禁止打电话	禁止打电话 📵
禁止扔垃圾	禁止扔垃圾 🚯
禁止自行车	禁止自行车 🚳
福克兰群岛	福克兰群岛 🇫🇰
科摩罗联盟	科摩罗联盟 🇰🇲
科研人员女	科研人员女 👩🏻‍🔬
科研人员男	科研人员男 👨🏻‍🔬
秘鲁共和国	秘鲁共和国 🇵🇪
站立的女人	站立的女人 🧍‍♀️
站立的男人	站立的男人 🧍‍♂️
笑得打滚儿	笑得打滚儿 🤣
笔记本电脑	笔记本电脑 💻
篮球运动员	篮球运动员 ⛹️‍♂️ ⛹️‍♀️
粗美元符号	粗美元符号 💲
索罗门群岛	索罗门群岛 🇸🇧
索马里联邦	索马里联邦 🇸🇴
红色倒三角	红色倒三角 🔻
红色正三角	红色正三角 🔺
纳扎护身符	纳扎护身符 🧿
线圈笔记本	线圈笔记本 🗒
给我打电话	给我打电话 🤙
美属萨摩亚	美属萨摩亚 🇦🇸
美式橄榄球	美式橄榄球 🏈
美洲地球仪	美洲地球仪 🌎
膨胀的爱心	膨胀的爱心 💗
自动人力车	自动人力车 🛺
自由女神像	自由女神像 🗽
芬兰共和国	芬兰共和国 🇫🇮
苏丹共和国	苏丹共和国 🇸🇩
英式橄榄球	英式橄榄球 🏉
茅利塔尼亚	茅利塔尼亚 🇲🇷
草地曲棍球	草地曲棍球 🏑️
荷属圣马丁	荷属圣马丁 🇸🇽
荷属阿鲁巴	荷属阿鲁巴 🇦🇼
莱索托王国	莱索托王国 🇱🇸
莲花坐的人	莲花坐的人 🧘‍♂️ 🧘‍♀️
蒙特内哥罗	蒙特内哥罗 🇲🇪
蒙特塞拉特	蒙特塞拉特 🇲🇸
蒸房里的人	蒸房里的人 🧖‍♂️ 🧖‍♀️
蓝色大菱形	蓝色大菱形 🔷
蓝色小菱形	蓝色小菱形 🔹
螺旋桨飞机	螺旋桨飞机 🛩️
螺母与螺栓	螺母与螺栓 🔩
螺母及螺栓	螺母及螺栓 🔩
螺母和螺栓	螺母和螺栓 🔩
行李寄存处	行李寄存处 🛅
行李领取处	行李领取处 🛄
西班牙王国	西班牙王国 🇪🇸
警车旋转灯	警车旋转灯 🚨
贝宁共和国	贝宁共和国 🇧🇯
赤道几内亚	赤道几内亚 🇬🇶
超级大反派	超级大反派 🦹‍♂️ 🦹‍♀️
跨性别符号	跨性别符号 ⚧
跳舞的女人	跳舞的女人 💃
跳舞的男人	跳舞的男人 🕺
运动会奖牌	运动会奖牌 🏅
这个我知道	这个我知道 🙋‍♂️ 🙋‍♀️
送你一颗心	送你一颗心 💝
逆时针方向	逆时针方向 🔄
金毛寻回犬	金毛寻回犬 🦮
锤子与扳手	锤子与扳手 🛠
锤子和扳手	锤子和扳手 🛠
长翅膀的钱	长翅膀的钱 💸
闪亮的星星	闪亮的星星 🌟
闪光灯打开	闪光灯打开 📸
闪耀的星星	闪耀的星星 🌟
阿尔及利亚	阿尔及利亚 🇩🇿
阿尔巴尼亚	阿尔巴尼亚 🇦🇱
阿拉丁灯神	阿拉丁灯神 🧞
阿拉丁神灯	阿拉丁神灯 🧞‍♂️ 🧞‍♀️
阿拉伯女人	阿拉伯女人 🧕🏾
阿曼苏丹国	阿曼苏丹国 🇴🇲
阿赫韦南马	阿赫韦南马 🇦🇽
难过但释然	难过但释然 😥
非洲地球仪	非洲地球仪 🌍
顺时针方向	顺时针方向 🔃
风吹拂的脸	风吹拂的脸 🌬
马戏团帐篷	马戏团帐篷 🎪
马桶疏通器	马桶疏通器 🪠
马绍尔群岛	马绍尔群岛 🇲🇭
马达加斯加	马达加斯加 🇲🇬
马里共和国	马里共和国 🇲🇱
骑自行车女	骑自行车女 🚴🏻‍♀️
骑自行车男	骑自行车男 🚴🏻‍♂️
高尔夫球女	高尔夫球女 🏌🏻‍♀️
高尔夫球手	高尔夫球手 🏌️‍♂️ 🏌️‍♀️
高尔夫球洞	高尔夫球洞 ⛳
高尔夫球男	高尔夫球男 🏌🏻‍♂️
高跟儿凉鞋	高跟儿凉鞋 👡
麻辣小龙虾	麻辣小龙虾 🦞
黄色小菱形	黄色小菱形 🔸️
黑色中方块	黑色中方块 ◻
黑色大方块	黑色大方块 ◽
黑色小方块	黑色小方块 ▫
东正教十字架	东正教十字架 ☦️
乌兹别克斯坦	乌兹别克斯坦 🇺🇿
乌干达共和国	乌干达共和国 🇺🇬
伊拉克共和国	伊拉克共和国 🇮🇶
佛得角共和国	佛得角共和国 🇨🇻
内心活动气泡	内心活动气泡 💭
冈比亚共和国	冈比亚共和国 🇬🇲
几内亚共和国	几内亚共和国 🇬🇳
南苏丹共和国	南苏丹共和国 🇸🇸
卢旺达共和国	卢旺达共和国 🇷🇼
卢森堡大公国	卢森堡大公国 🇱🇺
厄立特里亚国	厄立特里亚国 🇪🇷
去氧核糖核酸	去氧核糖核酸 🧬
双手手掌向上	双手手掌向上 🤲
叙利亚共和国	叙利亚共和国 🇸🇾
吉尔吉斯斯坦	吉尔吉斯斯坦 🇰🇬
吉布提共和国	吉布提共和国 🇩🇯
喀麦隆共和国	喀麦隆共和国 🇨🇲
国际象棋棋子	国际象棋棋子 ♔ ♕ ♖ ♗ ♘ ♙ ♚ ♛ ♜ ♝ ♞
土耳其共和国	土耳其共和国 🇹🇷
圣尤斯特歇斯	圣尤斯特歇斯 🇧🇶
垃圾入篓标志	垃圾入篓标志 🚮
塞舌尔共和国	塞舌尔共和国 🇸🇨
墨西哥合众国	墨西哥合众国 🇲🇽
墨西哥薄饼卷	墨西哥薄饼卷 🌮
复活节岛石像	复活节岛石像 🗿
奥地利共和国	奥地利共和国 🇦🇹
女举重运动员	女举重运动员 🏋️‍♀️
女办公室职员	女办公室职员 👩‍💼
女超级大反派	女超级大反派 🦹‍♀️
安哥拉共和国	安哥拉共和国 🇦🇴
密克罗尼西亚	密克罗尼西亚 🇫🇲
尼日利亚联邦	尼日利亚联邦 🇳🇬
尼日尔共和国	尼日尔共和国 🇳🇪
山地自行车女	山地自行车女 🚵🏻‍♀️
山地自行车男	山地自行车男 🚵🏻‍♂️
巴勒斯坦领土	巴勒斯坦领土 🇵🇸
巴拉圭共和国	巴拉圭共和国 🇵🇾
巴拿马共和国	巴拿马共和国 🇵🇦
布隆迪共和国	布隆迪共和国 🇧🇮
带墨水笔的锁	带墨水笔的锁 🔏
带画框的图片	带画框的图片 🖼
带花园的楼房	带花园的楼房 🏡
录音室麦克风	录音室麦克风 🎙
微笑的上弦月	微笑的上弦月 🌛
微笑的下弦月	微笑的下弦月 🌜
意大利共和国	意大利共和国 🇮🇹
愤怒对话气泡	愤怒对话气泡 🗯
手拉手的情侣	手拉手的情侣 👫
手指张开的手	手指张开的手 🖐
打草地曲棍球	打草地曲棍球 🏑️
打高尔夫的人	打高尔夫的人 🏌️‍♂️ 🏌️‍♀️
拉普拉斯算符	拉普拉斯算符 ∇² ∇·∇
掌心向上托起	掌心向上托起 🤲
撒拉威阿拉伯	撒拉威阿拉伯 🇪🇭
斯威士兰王国	斯威士兰王国 🇸🇿
新加坡共和国	新加坡共和国 🇸🇬
新喀里多尼亚	新喀里多尼亚 🇳🇨
旗杆上的旗帜	旗杆上的旗帜 🚩
暮色中的城市	暮色中的城市 🌆
橘黄色大菱形	橘黄色大菱形 🔶
橘黄色小菱形	橘黄色小菱形 🔸
沙乌地阿拉伯	沙乌地阿拉伯 🇸🇦
油炸鹰嘴豆饼	油炸鹰嘴豆饼 🧆
法兰西共和国	法兰西共和国 🇫🇷
法属南方属地	法属南方属地 🇹🇫
法属南部领地	法属南部领地 🇹🇫
法式长棍面包	法式长棍面包 🥖
波浪型破折号	波浪型破折号 〰️
注册商标符号	注册商标符号 ®
澳大利亚联邦	澳大利亚联邦 🇦🇺
热带水果饮料	热带水果饮料 🍹
爱尔兰共和国	爱尔兰共和国 🇮🇪
电子游戏手柄	电子游戏手柄 🎮
男举重运动员	男举重运动员 🏋️‍♂️
男办公室职员	男办公室职员 👨‍💼
男超级大反派	男超级大反派 🦹‍♂️
白十字安全帽	白十字安全帽 ⛑️
白线方形按钮	白线方形按钮 🔳
白色中等方块	白色中等方块 ◼
白色方形按钮	白色方形按钮 🔳
皮特凯恩群岛	皮特凯恩群岛 🇵🇳
皱着眉头的人	皱着眉头的人 🙍‍♂️ 🙍‍♀️
盘绕是炸鱼饼	盘绕是炸鱼饼 🍥
眉毛上挑的脸	眉毛上挑的脸 🤨
禁止乱丢垃圾	禁止乱丢垃圾 🚯
禁止乱扔垃圾	禁止乱扔垃圾 🚯
禁止使用手机	禁止使用手机 📵
禁止行人通行	禁止行人通行 🚷
科索沃共和国	科索沃共和国 🇽🇰
空中轨道列车	空中轨道列车 🚟
突尼斯共和国	突尼斯共和国 🇹🇳
立陶宛共和国	立陶宛共和国 🇱🇹
笑出眼泪的猫	笑出眼泪的猫 😹
笑得满地打滚	笑得满地打滚 🤣
系有缎带的心	系有缎带的心 💝
纳扎尔护身符	纳扎尔护身符 🧿
美利坚合众国	美利坚合众国 🇺🇸
美属维京群岛	美属维京群岛 🇻🇮
肯尼亚共和国	肯尼亚共和国 🇰🇪
脱氧核糖核酸	脱氧核糖核酸 🧬
苏里南共和国	苏里南共和国 🇸🇷
英属维京群岛	英属维京群岛 🇻🇬
荷属加勒比区	荷属加勒比区 🇧🇶
菲律宾共和国	菲律宾共和国 🇵🇭
萨摩亚独立国	萨摩亚独立国 🇼🇸
葡萄牙共和国	葡萄牙共和国 🇵🇹
蒸房里的女人	蒸房里的女人 🧖‍♀️
蒸房里的男人	蒸房里的男人 🧖‍♂️
视频游戏手柄	视频游戏手柄 🎮
请勿乱丢垃圾	请勿乱丢垃圾 🚯
请勿乱扔垃圾	请勿乱扔垃圾 🚯
赞比亚共和国	赞比亚共和国 🇿🇲
躺在床上的人	躺在床上的人 🛌
达朗贝尔算符	达朗贝尔算符 ☐²
进城务工人员	进城务工人员 👷🏻
迪戈加西亚岛	迪戈加西亚岛 🇩🇬
长了翅膀的钱	长了翅膀的钱 💸
长胡子的女人	长胡子的女人 🧔‍♀️
阿拉丁灯神女	阿拉丁灯神女 🧞‍♀️
阿拉丁灯神男	阿拉丁灯神男 🧞‍♂️
阿根廷共和国	阿根廷共和国 🇦🇷
雾气笼罩的桥	雾气笼罩的桥 🌁
饰以丝带的心	饰以丝带的心 💝
马拉维共和国	马拉维共和国 🇲🇼
马耳他共和国	马耳他共和国 🇲🇹
黎巴嫩共和国	黎巴嫩共和国 🇱🇧
黑线方形按钮	黑线方形按钮 🔲
黑色中等方块	黑色中等方块 ◻
黑色方形按钮	黑色方形按钮 🔲
两个牵手的女人	两个牵手的女人 👭
两个牵手的男人	两个牵手的男人 👬
中华人民共和国	中华人民共和国 🇨🇳
亚美尼亚共和国	亚美尼亚共和国 🇦🇲
休达及梅利利亚	休达及梅利利亚 🇪🇦
休达和梅利利亚	休达和梅利利亚 🇪🇦
保加利亚共和国	保加利亚共和国 🇧🇬
修复受伤的心灵	修复受伤的心灵 ❤️‍🩹
做成心形的双手	做成心形的双手 🫶
克罗地亚共和国	克罗地亚共和国 🇭🇷
列支敦士登公国	列支敦士登公国 🇱🇮
利比里亚共和国	利比里亚共和国 🇱🇷
北马其顿共和国	北马其顿共和国 🇲🇰
北马利安纳群岛	北马利安纳群岛 🇲🇵
北马里亚纳群岛	北马里亚纳群岛 🇲🇵
千里达及多巴哥	千里达及多巴哥 🇹🇹
千里达及托巴哥	千里达及托巴哥 🇹🇹
博茨瓦纳共和国	博茨瓦纳共和国 🇧🇼
卡片索引分隔卡	卡片索引分隔卡 🗂
厄瓜多尔共和国	厄瓜多尔共和国 🇪🇨
反手食指向上指	反手食指向上指 👆
反手食指向下指	反手食指向下指 👇
反手食指向右指	反手食指向右指 👉
反手食指向左指	反手食指向左指 👈
吉尔吉斯共和国	吉尔吉斯共和国 🇰🇬
哥伦比亚共和国	哥伦比亚共和国 🇨🇴
圣基茨和尼维斯	圣基茨和尼维斯 🇰🇳
圣多美普林西比	圣多美普林西比 🇸🇹
圣皮耶与密克隆	圣皮耶与密克隆 🇵🇲
圣马力诺共和国	圣马力诺共和国 🇸🇲
坐手动轮椅的人	坐手动轮椅的人 👨‍🦽 👩‍🦽
坐电动轮椅的人	坐电动轮椅的人 👨‍🦼 👩‍🦼
基里巴斯共和国	基里巴斯共和国 🇰🇮
塞内加尔共和国	塞内加尔共和国 🇸🇳
塞尔维亚共和国	塞尔维亚共和国 🇷🇸
塞拉利昂共和国	塞拉利昂共和国 🇸🇱
塞浦路斯共和国	塞浦路斯共和国 🇨🇾
多米尼加共和国	多米尼加共和国 🇩🇴
大红灯笼高高挂	大红灯笼高高挂 🏮
失望但如释重负	失望但如释重负 😥
子弹头高速列车	子弹头高速列车 🚅
安地卡及巴布达	安地卡及巴布达 🇦🇬
安提瓜和巴布达	安提瓜和巴布达 🇦🇬
尼加拉瓜共和国	尼加拉瓜共和国 🇳🇮
已静音的扬声器	已静音的扬声器 🔇
巴布亚新几内亚	巴布亚新几内亚 🇵🇬
巴布亚纽几内亚	巴布亚纽几内亚 🇵🇬
巴西联邦共和国	巴西联邦共和国 🇧🇷
带单片眼镜的脸	带单片眼镜的脸 🧐
带蝴蝶结的帽子	带蝴蝶结的帽子 👒
开闪光灯的相机	开闪光灯的相机 📸
戴助听器的耳朵	戴助听器的耳朵 🦻
拉脱维亚共和国	拉脱维亚共和国 🇱🇻
拿着白手杖的人	拿着白手杖的人 👨‍🦯 👩‍🦯
摩尔多瓦共和国	摩尔多瓦共和国 🇲🇩
文莱达鲁萨兰国	文莱达鲁萨兰国 🇧🇳
斯洛伐克共和国	斯洛伐克共和国 🇸🇰
旗杆上的三角旗	旗杆上的三角旗 🚩
日本初学者标志	日本初学者标志 🔰
星光闪闪的夜晚	星光闪闪的夜晚 🌃
朝左的对话气泡	朝左的对话气泡 🗨
欧洲非洲地球仪	欧洲非洲地球仪 🌍
正中靶心的飞镖	正中靶心的飞镖 🎯
毛里求斯共和国	毛里求斯共和国 🇲🇺
沙特阿拉伯王国	沙特阿拉伯王国 🇸🇦
法属波利尼西亚	法属波利尼西亚 🇵🇫
法属玻里尼西亚	法属玻里尼西亚 🇵🇫
津巴布韦共和国	津巴布韦共和国 🇿🇼
洪都拉斯共和国	洪都拉斯共和国 🇭🇳
澳门特别行政区	澳门特别行政区 🇲🇴
爱沙尼亚共和国	爱沙尼亚共和国 🇪🇪
瓦利斯和富图纳	瓦利斯和富图纳 🇼🇫
瓦努阿图共和国	瓦努阿图共和国 🇻🇺
白线正方形按钮	白线正方形按钮 🔳
白色正方形按钮	白色正方形按钮 🔳
白边线方形按钮	白边线方形按钮 🔳
科特迪瓦共和国	科特迪瓦共和国 🇨🇮
笑得满地打滚儿	笑得满地打滚儿 🤣
约旦哈希姆王国	约旦哈希姆王国 🇯🇴
纳米比亚共和国	纳米比亚共和国 🇳🇦
缅甸联邦共和国	缅甸联邦共和国 🇲🇲
美属维尔京群岛	美属维尔京群岛 🇻🇮
英属印度洋领地	英属印度洋领地 🇮🇴
英属维尔京群岛	英属维尔京群岛 🇻🇬
莫桑比克共和国	莫桑比克共和国 🇲🇿
萨尔瓦多共和国	萨尔瓦多共和国 🇸🇻
运动型多用途车	运动型多用途车 🚙
进城务工人员女	进城务工人员女 👷🏻‍♀️
进城务工人员男	进城务工人员男 👷🏻‍♂️
逆时针垂直箭头	逆时针垂直箭头 🔄
阿塞拜疆共和国	阿塞拜疆共和国 🇦🇿
阿斯克勒庇俄斯	阿斯克勒庇俄斯 ⚕
顺时针垂直箭头	顺时针垂直箭头 🔃
食指指向观察者	食指指向观察者 🫵
香港特别行政区	香港特别行政区 🇭🇰
马尔代夫共和国	马尔代夫共和国 🇲🇻
马尔维纳斯群岛	马尔维纳斯群岛 🇫🇰
高速子弹头列车	高速子弹头列车 🚅
高音量的扬声器	高音量的扬声器 🔊
黑线正方形按钮	黑线正方形按钮 🔲
黑色正方形按钮	黑色正方形按钮 🔲
黑边线方形按钮	黑边线方形按钮 🔲
东帝汶民主共和国	东帝汶民主共和国 🇹🇱
中等音量的扬声器	中等音量的扬声器 🔉
乌拉圭东岸共和国	乌拉圭东岸共和国 🇺🇾
伊朗伊斯兰共和国	伊朗伊斯兰共和国 🇮🇷
几内亚比绍共和国	几内亚比绍共和国 🇬🇼
印度尼西亚共和国	印度尼西亚共和国 🇮🇩
哈萨克斯坦共和国	哈萨克斯坦共和国 🇰🇿
哥斯达黎加共和国	哥斯达黎加共和国 🇨🇷
圣多美和普林西比	圣多美和普林西比 🇸🇹
圣文森及格瑞那丁	圣文森及格瑞那丁 🇻🇨
圣皮埃尔和密克隆	圣皮埃尔和密克隆 🇵🇲
圭亚那合作共和国	圭亚那合作共和国 🇬🇾
坐手动轮椅的女人	坐手动轮椅的女人 👩‍🦽
坐手动轮椅的男人	坐手动轮椅的男人 👨‍🦽
坐电动轮椅的女人	坐电动轮椅的女人 👩‍🦼
坐电动轮椅的男人	坐电动轮椅的男人 👨‍🦼
塔吉克斯坦共和国	塔吉克斯坦共和国 🇹🇯
多民族玻利维亚国	多民族玻利维亚国 🇧🇴
德意志联邦共和国	德意志联邦共和国 🇩🇪
指向观察者的食指	指向观察者的食指 🫵
斯洛文尼亚共和国	斯洛文尼亚共和国 🇸🇮
斯瓦尔巴和扬马延	斯瓦尔巴和扬马延 🇸🇯
日本新手驾驶标志	日本新手驾驶标志 🔰
特立尼达和多巴哥	特立尼达和多巴哥 🇹🇹
特里斯坦达库尼亚	特里斯坦达库尼亚 🇸🇭
画面太美我不敢看	画面太美我不敢看 🫣
白边线正方形按钮	白边线正方形按钮 🔳
索马里联邦共和国	索马里联邦共和国 🇸🇴
美国本土外小岛屿	美国本土外小岛屿 🇺🇲
讲话者的头部剪影	讲话者的头部剪影 🗣
阿尔巴尼亚共和国	阿尔巴尼亚共和国 🇦🇱
阿拉伯联合酋长国	阿拉伯联合酋长国 🇦🇪
马达加斯加共和国	马达加斯加共和国 🇲🇬
黑边线正方形按钮	黑边线正方形按钮 🔲
中国澳门特别行政区	中国澳门特别行政区 🇲🇴
中国香港特别行政区	中国香港特别行政区 🇭🇰
乌兹别克斯坦共和国	乌兹别克斯坦共和国 🇺🇿
土克斯及开科斯群岛	土克斯及开科斯群岛 🇹🇨
坦桑尼亚联合共和国	坦桑尼亚联合共和国 🇹🇿
尼日利亚联邦共和国	尼日利亚联邦共和国 🇳🇬
波士尼亚赫塞哥维纳	波士尼亚赫塞哥维纳 🇧🇦
浮在地面上的西装男	浮在地面上的西装男 🕴
特克斯和凯科斯群岛	特克斯和凯科斯群岛 🇹🇨
特里斯坦–达库尼亚	特里斯坦–达库尼亚 🇹🇦
科科斯（基林）群岛	科科斯（基林）群岛 🇨🇨
老挝人民民主共和国	老挝人民民主共和国 🇱🇦
越南社会主义共和国	越南社会主义共和国 🇻🇳
那画面太美我不敢看	那画面太美我不敢看 🫣
阿拉伯叙利亚共和国	阿拉伯叙利亚共和国 🇸🇾
食指和拇指交叉的手	食指和拇指交叉的手 🫰
圣克里斯多福及尼维斯	圣克里斯多福及尼维斯 🇰🇳
圣文森特和格林纳丁斯	圣文森特和格林纳丁斯 🇻🇨
圣皮埃尔和密克隆群岛	圣皮埃尔和密克隆群岛 🇵🇲
已锁上但挂着钥匙的锁	已锁上但挂着钥匙的锁 🔐
巴基斯坦伊斯兰共和国	巴基斯坦伊斯兰共和国 🇵🇰
巴布亚新几内亚独立国	巴布亚新几内亚独立国 🇵🇬
波斯尼亚和黑塞哥维纳	波斯尼亚和黑塞哥维纳 🇧🇦
波斯尼亚和黑塞哥维那	波斯尼亚和黑塞哥维那 🇧🇦
赫德岛和麦克唐纳群岛	赫德岛和麦克唐纳群岛 🇭🇲
南乔治亚与南三明治群岛	南乔治亚与南三明治群岛 🇬🇸
南乔治亚和南桑威奇群岛	南乔治亚和南桑威奇群岛 🇬🇸
委内瑞拉玻利瓦尔共和国	委内瑞拉玻利瓦尔共和国 🇻🇪
毛里塔尼亚伊斯兰共和国	毛里塔尼亚伊斯兰共和国 🇲🇷
特立尼达和多巴哥共和国	特立尼达和多巴哥共和国 🇹🇹
特里斯坦–达库尼亚群岛	特里斯坦–达库尼亚群岛 🇹🇦
埃塞俄比亚联邦民主共和国	埃塞俄比亚联邦民主共和国 🇪🇹
阿尔及利亚民主人民共和国	阿尔及利亚民主人民共和国 🇩🇿
圣多美和普林西比民主共和国	圣多美和普林西比民主共和国 🇸🇹
大不列颠及北爱尔兰联合王国	大不列颠及北爱尔兰联合王国 🇬🇧
斯里兰卡民主社会主义共和国	斯里兰卡民主社会主义共和国 🇱🇰
